鸡	jiem
隼	syoj
蔑	mpti
氡	dsom
德	dehp
淖	ncej
垭	yagc
倕	ivom
蝎	xplv
蛸	xnlb
值	viom
脚	jnbl
骼	gebr
口	kzrr
散	sjtk
俏	qnob
榔	lhdl
录	lune
珀	poma
氮	djof
哏	gfrv
灭	mpmf
躏	lbrg
自	zihu
取	quse
拆	idqy
掐	qxqx
琨	kymp
贼	zwbk
哗	hxrj
磴	dgmt
添	tmep
甲	jxwl
槐	hkdi
苗	mntw
昳	dpao
瞍	szbe
淬	cvej
镕	rsor
售	uzor
崩	bgub
枘	rvdb
临	lbla
廊	lhil
芠	wftk
窕	tnjo
溶	rser
邋	layv
骺	hzbr
仗	vhok
坪	pkgj
写	xpbm
辍	ioke
素	suqf
萼	eets
篇	pmhb
鳣	vjnm
西	ximw
烂	ljfm
凹	aosu
盎	ahlt
袷	qxlr
脶	lobb
献	xmjk
犴	hjkj
适	uiyr
犹	yzku
啵	bore
戎	rsik
宋	ssjd
屡	lvsv
腌	aabu
崭	vjul
塄	lggs
挠	ncqu
筌	qrhg
邨	cypl
振	vfqv
耒	lwqd
鲠	ggnk
强	qlni
硅	gvmg
蔻	kzte
璞	pumo
疼	tgky
看	kjhu
腠	czbk
清	qkeb
降	jlnq
糖	thfr
垫	dmqg
𫑡	mgrl
瘪	bpkp
掉	dnqj
肘	vzbi
耐	ndmi
禳	rhiv
慌	hlpu
调	dnir
盾	dyhu
露	lzmr
腩	njbj
篷	pghj
钊	vcon
焜	kyfp
窥	kvju
糊	hufb
捉	voqo
瘁	cvkj
请	qkib
獠	lnkf
揭	jpqv
蛑	mzlq
该	gdio
睃	sobe
吊	dnrb
崛	jtuu
獗	jtko
媞	tivo
活	hoer
刘	lqyn
噌	cgra
其他	qita
叁	sjim
骰	tzbe
熬	aogf
尜	gaff
艇	tkhg
囟	xbhk
虿	idmi
訚	yblr
酸	srme
燕	yjtf
义	yiik
嫘	lwvf
壶	hugc
删	ujbn
挪	noql
姻	ybvk
颀	qiho
镁	mwok
似	sioo
光	glfu
喝	herv
缜	vfvc
瓒	zjmo
空	ksjm
嘀	dirb
驲	rina
簇	cuhk
狨	rskk
涯	yaeg
鲖	tsnr
毒	duqj
麻	maid
感觉	gjjt
咽	yjrk
腔	qlbm
扔	rgqs
丁	dkmn
派	pdev
薰	xytf
罹	liwg
蚌	bglj
囚	qqwo
高	gcyr
葵	kvtk
抹	maqj
峁	mcul
诸	vuia
畔	pjwq
厕	cemn
木	mudd
睫	jpbo
扩	koqi
遵	zyyi
嵫	ziui
烷	wjfu
台	tdir
南	najj
铺	puob
膑	bbbc
萑	hrtg
牌	pdlj
租	zuhm
大	dakk
入	ruoh
蟒	mhlt
奥	aohk
钼	muou
膊	bobi
虐	ntym
人	rfoo
镍	npod
爪	vxho
闽	mbli
臻	vfmd
洼	waeg
绚	xrva
荒	hltv
型	xkmg
皿	mbbt
邻	lbol
岬	jxul
卸	xpol
魋	tvhg
蝰	kvlg
黝	yzws
肷	qmbo
里	liwg
晖	hvaq
越	ytgv
堵	duga
审	ufjl
盲	mhyu
胸	xsbk
房	fhhs
碱	jmmr
腰	ycbv
鸟	nnpm
酣	hjmm
蚊	wflk
爱	aibe
芥	jptl
祸	hoib
嘣	bgrb
幅	fulw
蠲	jrci
蛉	lkli
胚	pwbm
稹	vfhc
澎	pgeh
祀	simu
豉	iime
毋	wuwh
阃	kyld
沧	cheu
㧟	kkqs
纰	pivp
蹦	bgrb
辔	pwvr
卿	qkhl
百	bdma
房	fhms
啉	lbrd
刹	iakn
铌	niop
牁	kevr
瓦	wami
姐	jpvm
偷	tzon
炖	dyfu
账	vhbo
咬	ycrk
鲻	zinw
蛇	uelp
埝	nmgp
癫	dmko
夸	kxks
竹	vuhh
邱	qqol
拼	pbqj
裼	tilh
第	dihh
泷	lsep
隆	lsnm
向	xlhr
垂	ivhm
复	fuoe
筷	kkhk
沛	pweb
裥	jmla
男	njws
锻	droe
何	heor
耩	jlqb
糟	zcfa
交	jnyk
岸	anuj
二	ermm
恐	ksmp
违	wwys
劾	heys
鲂	fhns
喳	varm
摁	enqp
豚	tybo
倪	niou
拄	vuqg
耷	dakj
饷	xlnr
篌	hzhk
祭	vdbf
侃	kjov
栲	kcds
萩	qqtf
仇	izon
妮	nivp
逛	glyg
绣	xqvs
版	bjle
成	igis
壸	kygc
蔌	suto
震	vfmv
郭	goyl
乎	huhd
蛲	nclu
互	humm
荛	rctu
嘌	pnrf
郴	ifdl
确	qtmq
孱	cjsd
镜	jkou
廷	tkng
瓜	gxho
崾	ycuv
筏	fahi
俵	bnov
扛	khqm
啼	tirb
返	fjye
跟	gfrv
老	lcjp
僚	lnof
寝	qbje
专	vrqi
芽	yath
拴	urqg
佝	gzor
坯	pigm
始	uivr
奘	vlvk
旧	jqla
糕	gcff
迓	yayh
揩	kdqa
笑	xnhk
攒	crqo
藏	chts
褛	lvlv
荑	titn
甯	nkjq
尥	lnki
豆	dzmt
啫	vera
尊	zyci
更	ggmk
脍	kkbi
熊	xsif
拐	gkqh
了	lnnn
姈	lkvi
赦	uegk
嗡	wgrm
兜	dzhu
镥	luoa
兄	xsru
孽	nptd
蜣	qllu
缩	sova
擤	xkqt
嫜	vhvj
幢	vllg
节	jptl
肖	xnfb
碓	dvmg
摸	moqk
栐	ysde
处	iuhy
颁	bjco
登	dgnt
遭	zcya
参加	cjjx
唵	anru
长	vhpo
脆	cvbu
猎	lpka
贼	zwbj
窘	jsjr
被	bwle
胲	hdbo
盛	ugit
洪	hsec
髂	qxbr
粹	cvfj
愭	qipa
伴	bjoq
箬	rohr
凸	tubs
范	fjtu
儿	erlu
赠	zgba
黯	anwa
桌	voyd
恕	uuvp
舜	uybq
诨	hyiq
蹁	pmrb
序	xuin
绷	bgvb
汪	wheg
托	toqp
骂	marm
潘	pjew
淋	lbed
艋	mght
昺	bkab
麟	lbiq
墩	dygk
个	geol
蹒	pjrb
重新	isxb
雷	lwmw
宾	bbjc
耀	ycfg
蕨	jtto
哈	harr
额	eejo
馊	szne
锝	deoi
词库	ciku
进	jbyt
化	hxop
幄	wolg
徭	ychu
桑	shed
腌	aabv
黜	iuwu
槛	kjdt
暂	zjka
舔	tmhp
耵	dksn
腽	wabt
嚓	carf
扦	qmqj
绒	rsvj
崆	ksum
囔	nhrv
幸	xkgj
痈	yskq
郧	yyrl
宿	xqja
糯	nofb
梏	gudr
肭	nabb
甜	tmmm
拎	lbql
贝	bwbo
雹	bcmu
啦	lart
弟	dich
铯	seou
谁	uwig
晨	ifav
能	ngip
勇	ysns
昔	xita
税	uvhu
症	vgkm
倥	ksom
拧	nkqn
供	gsoc
孔	ksnu
弃	qiyt
镶	xlov
秆	gjhj
甾	zdvw
肛	ghbm
褐	help
拓	taqr
峻	jyue
馓	sjnk
海	hdej
鲭	qknb
塞	sejg
溴	xqek
恭	gstp
钫	fhos
岁	svui
刖	ytbn
冈	ghbk
搐	iuqw
谟	moik
哞	mzrq
遐	xxye
挂	gxqg
庆	qkik
舟	vzhi
眦	zibp
缌	sivp
哽	ggrk
垱	dhgm
诈	vais
嗯	onrp
娼	ihva
各	gehr
陕	ujnt
袖	xqlw
堧	rrgk
魂	hymi
溺	nneh
糨	jlfi
笋	syhk
萜	tptr
陂	bwne
楷	kdda
冕	mmau
荞	qntl
沤	ouek
凯	kdun
螨	mjlb
囊	nhjv
祆	xmmk
帛	bohb
才	cddh
曹	ccta
混	hyep
社	ueig
矬	coog
鹄	huhm
禾	hehd
廓	koil
灞	baeb
七	qijv
鲱	fwny
臭	xqhk
菌	jytd
和	huhr
崚	lgue
旺	whag
懒	ljpo
茜	qmtw
乃	ndns
阏	eely
见	xmbu
婧	jkvb
热	reqf
目	mubu
终	vsvy
轨	gvkn
俎	zuom
垴	ncgk
敏	mbok
掇	doqe
螵	pnlf
瘘	lzkv
切	qpph
另	lkrs
捅	tsqb
坤	kygl
鳎	tanm
琅	lhmv
孕	yynd
歃	uaho
运	yyyi
几	jihn
敉	mifk
陡	dzno
授	uzqe
罩	vcwj
哔	birj
垢	gzgr
陌	mona
佳	jxog
猿	yrkv
女	nvvv
绱	uhvr
幕	mutb
色	udnu
寁	zjjo
脱	tobu
珰	dhmm
迫	pdya
躺	thhr
随着	svve
吃	iirn
姒	sivo
骤	vzno
安装	anvl
芭	batu
咣	glru
喝	herp
臊	scbd
荼	tutd
蓊	wgtm
诺	noir
削	xnfn
遘	gzyb
拇	muqi
笼	lshp
莫	motk
哨	ucrb
氖	ndos
钓	dnoi
裸	lold
缲	qnvd
葎	lvtq
参	cjih
翁	wgcm
觅	mibu
欸	eiio
徂	cuhm
舸	gehr
给	gwvr
甩	ukbu
也	yepd
根	gfdv
拨	boqe
岢	keur
骨	gubb
汊	iaei
瞌	kebt
垤	dpgg
缗	mbva
瘥	idkm
薿	nito
韧	rfqi
伺	cior
忑	temp
焙	bwfr
梾	lddt
祆	xmik
坼	iegy
荟	hvti
撒	saqk
乒	pkoh
妥	tobv
受	uzbe
铁	tpoo
匙	iiap
俊	jyoe
卬	ahhl
了	lenn
苤	pptm
迎	ykyl
𡐓	khge
幺	ycvi
轧	gaku
曲	qutw
蚪	dzlj
蘼	mity
析	xidl
至	vimg
肚	dubg
弱	ronh
臧	zhil
称	ighf
怨	yrnp
肌	jibn
首	uztu
哄	hsrc
脟	lpbi
靥	yemw
懈	xppq
怠	ddip
鲎	hzfm
眭	svbg
忿	ffcp
佤	waon
捣	dcqu
理	limg
喽	lzrv
杻	nqdg
敲	qnye
哙	kkri
立	liyt
歪	wdmm
鞋	xptg
蹿	crrl
帮	bhqb
庖	pciu
淘	tceu
宿	suja
寻	xysi
城	iggs
睇	dibh
琼	qsmf
雇	guig
猾	hxkb
鹿	luip
玚	ihmh
仃	dkon
嚼	jtri
夭	ychk
音	ybya
汰	tdei
鲊	vans
蜷	qrlu
醉	zvmj
垒	lwig
趣	quge
懂	dspg
玚	yhmh
馌	yent
弨	icnr
奏	zzqk
绫	lkve
悯	mbpk
亏	kvms
傩	noog
覆	fume
蕊	rvtp
说	uoiu
逑	qqye
胀	vhbo
揸	vaqm
秦	qbqd
垠	ybgv
踊	ysrb
坏	hkgf
䌹	jsvr
栳	lcdp
霜	ulmu
珍	vfmh
阱	jknt
榕	rsdr
戏	xiei
妁	uovi
驰	iind
旒	lqyu
蘘	rhtv
眸	mzbq
柊	vsdy
刺	cidn
齇	vahm
柳	lqdl
含	hjor
绻	qrvu
奶	ndvs
陔	gdno
夙	suhi
债	vdoo
锲	qpok
摈	bbqc
钿	dmow
笃	duhm
直接	vijp
兹	ziti
烹	pgyf
鏖	aoic
磁	cimi
帱	izli
抛	pcqs
烫	thef
鳙	ysnb
央	yhlk
鞡	latt
丑	izng
牦	mchu
时候	uihz
锣	loon
缁	zivw
朕	vfbk
撮	zoqe
行	xkhn
攮	nhqv
脬	pcbd
爟	grfg
港	gheu
爰	yrbe
骢	csnp
钭	dzoj
赴	fugy
箍	guhb
怖	bupb
崮	guur
袤	mcyv
茈	zitp
张	vhno
应	ykim
圳	vfgl
拖	toqd
低	dioi
暖	nrae
庄	vlig
甘	gjtm
庭	tkig
趄	qpgm
损	syqo
漦	sije
姨	yivn
皴	cyie
阊	ihla
癌	aiku
呃	eeru
撬	qnqu
劫	jpgs
仅	jboe
晐	gdao
婶	ufvl
坠	vvng
网	whbk
欸	aiio
晁	icao
乜	npps
庵	aniv
钪	khon
璺	wfhi
反	fjhe
咯	lorr
㫰	lhav
苣	quts
玱	qlmu
龠	ytob
傧	bboc
背	bwlb
拱	gsqc
碜	ifmh
阶	jpnl
箨	tohq
答	dahr
嘿	hwrf
婘	qrvu
坐	zoog
桃	tcdo
仍	rgos
庥	xqid
觏	gztu
绰	iovj
庹	toio
钧	jyom
春	iyqa
疮	ilku
猱	nckd
椓	vodo
忆	yipn
传	iroi
煤	mwfd
噗	puro
腯	tubu
葩	patu
僮	vlog
位置	wwvi
胼	pmbt
睦	mubg
涕	tieh
蠊	lmlc
箐	qkhb
腮	sdbp
阍	hyla
偿	ihoi
鹊	qttm
郑	vgtl
皎	jnhk
懋	mcdp
耑	drul
坳	aogs
豳	bbuo
缤	bbvc
钕	nvov
退	tvyv
鹧	veim
吐	turg
邓	dgel
卡	qxyy
佃	dmow
琵	pimp
承	igno
救	jqik
排	pdqy
沁	qbep
纶	lyvp
臜	zabo
纂	zrhf
唾	torm
锋	fgoj
养	yhtl
寺	sigi
嗉	surf
嘹	lnrf
疃	trwg
桉	andv
苕	uctr
势	uiqs
髌	bbbc
汝	ruev
薸	pntf
锷	eeos
垮	kxgs
捂	wuqr
郎	lhil
贯	grwo
灯	dgfn
螳	thlg
郝	hcgl
鲍	bcnu
适	koyr
象	xlno
朔	uotb
娆	rcvu
宜	yijm
截	jpjg
脑	ncbk
蜢	mglt
蠲	jrti
桠	yadc
鲴	gunr
田	tmww
笏	huhh
哆	dorn
撰	vrqc
滂	phes
愤	ffpo
石	djmr
铥	dqoi
盼	pjbh
雇	guhg
陆	lqnu
晒	udaw
翘	qnjm
瘾	ybkp
氨	anov
设	ueie
侥	ycou
壬	rfhg
铡	vaon
信	xbor
鳃	sdnp
哇	warg
悸	jipd
轸	vfkh
赫	hegc
鳕	xtns
跃	ytrk
狡	jnkk
绦	tcvd
恋	lmyp
狒	fwkn
吓	xxry
肱	gsbi
坭	nigp
遗	yiyo
职	visc
姹	iavp
提	tiqo
瓀	rrmb
绊	bjvq
簪	zjha
蹴	curu
邀	ycyk
吱	vire
耙	paqu
患	hrlp
藁	gctd
菘	ssti
办	bjkc
炟	dafm
乏	faho
匠	jlsl
葶	tktn
蒇	ijto
诀	jtik
漂	pnef
撇	ppqk
樽	zydi
㠇	jquu
镄	fwoo
狨	rskj
抠	kzqk
榫	sydj
钔	mfos
袒	tjlm
舱	chhu
坡	poge
森	sfdd
搜	szqe
噻	sdrg
逞	igyg
碡	vzmy
服	fube
😊	oiwx
帚	vzsb
螋	szle
们	mfos
昒	huah
飧	synv
南	njjj
肟	wobs
趴	parc
妹	mwvd
色	senu
蝇	yklu
桥	qndl
子	zind
皂	zchp
韧	rfqh
胍	gxbo
聍	nksn
惩	ighp
良	lliv
犸	makm
璪	zcmd
死	simp
参	cfih
叵	posr
蛤	halr
民	mbrp
唔	ogrr
角	jnnq
膏	gcyb
九	jqkn
按	anqv
獯	xykf
镑	bhos
砜	fgmk
媓	hlvg
佬	lcop
砝	fami
锘	noor
圌	ivwb
嚷	rhrv
磐	pjhr
份	ffoh
皆	jppa
康	khie
侉	kxos
嘡	thrg
蒯	kktn
猛	mgkt
芹	qbtl
湄	mweu
倭	woov
铸	vuoi
舵	dohp
捺	naqf
蚝	hclu
习	xism
荒	hltu
䁖	lzbv
叮	dkrn
忸	nqpg
挺	tkqg
覃	qbmj
铛	dhom
髢	disd
祯	vfio
睚	yabg
极	jide
孀	ulvu
馁	nwnv
所	sohl
踒	worv
俸	fgoq
茗	mktr
怛	dapm
啊	aarr
后	hzhr
经	jkvm
峛	liun
造	zcyr
酾	udmb
珥	ermj
招	vcqr
铑	lcop
缶	fzou
睄	ucbb
鸣	mkrm
窗	iljn
嵩	ssub
慑	uepe
磊	lwmr
拢	lsqp
繁	fjof
玥	ytmb
绕	rcvu
嫌	xmvc
邝	klil
工	gsmm
著	vuta
脲	nnbe
戆	ghyp
符	fuhi
吴	wurk
阮	rrnu
胩	kaby
襻	pjlq
钮	nqog
咉	yhrk
葬	zhtt
槜	zvds
焐	wufr
瞭	lnbf
昧	mwad
剖	pzyn
篮	ljht
观	greu
推	tvqg
沱	toep
矛	mcnh
均	jygm
褟	talm
蜩	tnlr
剅	lzmn
荙	datk
苠	mbtp
沸	fwen
忒	teip
邦	bhhl
禳	rhmv
杲	gcad
妫	gvvs
啜	ikre
全	qrog
祋	dvme
坜	ligs
珺	jymr
邕	ysvu
液	yeek
丐	gdms
霖	lbmd
旱	hjaj
琢	zomo
遏	eeyv
懦	nopb
权	qrde
抟	trqi
你	niof
湍	treb
润	ryeg
页	yemo
猪	vuka
伞	sjoj
冬	dshy
砌	qpmh
妇	fuvm
锤	ivom
盖	gett
麇	qyid
丹	djby
突	tujk
怜	lmpl
饶	rcnu
骀	tdnr
妯	vzvw
温	wfet
财	cdbh
而	erml
仔	zdod
跐	cirp
踩	cdrd
黾	mbru
可	kemr
裉	kflv
铙	ncou
扎	zaqu
洒	saew
刽	gvon
岗	ghuk
聆	lksl
侪	idol
簧	hlhc
踢	tirh
鹾	coym
胯	kxbs
盟	mgat
盯	dkbn
圙	ltww
响	xlrr
跨	kxrs
念	nmop
蜱	pilj
孓	jtno
涨	vheo
此	ciyp
寸	cydi
镦	dvok
澈	ieek
觉	jnfu
魄	pohi
湓	pfet
刮	gxhn
硌	lomr
搅	jnqu
鳟	zyni
卵	lrhi
之	viio
备	bwhw
亍	iumn
娅	yavc
蚤	zcei
婍	qivr
鼾	hjhj
掺	cjqh
堤	digo
菡	hjte
串	irll
框	kldg
抔	pzqf
团	trwh
在	zdkg
娟	jrvb
瑰	gvmi
镣	lnof
冉	rjgb
丧	shgv
唵	anrv
壳	kegn
挥	hvqq
怂	ssop
搡	shqd
总算	zssr
楼	lzdv
旄	mcyu
赛	sdjo
扫	scqm
彬	bbdh
亘	gfmm
省	xkfu
苷	gjtm
荣	rstd
冲	isil
糁	sjfh
躜	zrro
对	dvei
诅	zuim
揆	kvqk
扯	ieqm
倍	bwor
喃	njrj
妭	bavk
赔	pwbr
玻	bome
脎	sabd
琛	ifmd
直	vijv
茁	votu
鳅	qqnf
姊	zivh
想	xldp
鲷	dnnr
鲑	gvng
醋	cuma
耿	ggsf
耍	uxmv
息	xihp
白	bdha
磅	phms
犟	jlnq
傻	uaoe
恩	enwp
鲌	bona
悬	xrbp
管	grhr
暗	anaa
凤	fghe
胪	lubs
戌	xuim
呢	nerp
送	ssyk
宴	yjjv
摘	vdqb
鳏	grne
玭	pbmp
搪	thqr
域	yugm
夬	gkdk
王	whmg
奔	bfkt
遑	hlyg
俱	juoc
汤	theh
北	bwlp
赚	vrbc
培	pwgr
钱	qmoj
希	xikb
胳	gabr
准	vyig
阅	ytlu
坎	kjgo
祧	tnmo
靳	jbtl
球	qqme
跌	dpro
年	nmoq
趑	zigo
驴	lvns
滚	gyev
蔷	qltw
绒	rsvk
冬	dshm
联	lmsk
缕	lvvv
花	hxtp
擂	lwqw
踅	xtqo
药	ycti
尥	lnkm
婷	tkvn
篼	dzhu
柞	zods
饹	lenr
堋	pggb
滇	dmec
咸	xmir
鲼	ffno
褪	tvlv
撕	siql
悲	bwlp
猕	mikf
渺	mneh
恁	nfop
讧	hsim
芳	fhts
搂	lzqv
抒	uuqn
构	gzdi
靿	ycts
罪	zvwy
浍	kkei
耕	ggqt
跑	pcru
蒂	ditb
勘	kjts
捶	ivqm
缫	scvd
到	dcmn
獬	xpkq
宵	xnjb
😊	oixn
偶	ouob
犬	qrik
缛	ruvi
眨	vabo
捎	ucqb
悰	cspf
氡	dsoy
柔	rznd
膀	bhbs
窜	crjl
舒	uuon
阻	zunm
狸	likg
摔	ukqj
攉	hoqg
瞧	qnbf
铍	pioe
六	lqyc
澄	iget
掣	iehq
灶	zcfg
晕	yyaq
弛	iind
角	jnng
缑	gzvk
缰	jlvm
署	uuwa
晤	wuar
耔	ziqd
崀	lhuv
纨	wjvk
携	xpqs
俺	anou
牟	muiq
其	qitc
嫂	scve
手	uzqq
岣	gzur
饲	sinr
汴	bmey
错	cooa
跛	bore
小	xnnc
螺	lolf
氟	fuon
钞	icoh
踏	tara
公司	gssi
冒	mcau
螟	mklc
觑	quyu
娃	wavg
勿	wuph
瀛	ykev
籀	vzhw
秀	xqhs
码	mamm
宽	krju
趔	lpgn
七	qiju
忠	vslp
计	jiij
螭	iilb
偲	cdop
苯	bftm
荮	vzti
蛙	walg
共	gstc
衰	ukyv
迷	miyd
茂	mcth
撞	vlqg
溉	gdeu
熏	xyhf
峘	hrum
洽	qxer
氩	yaoc
晡	buab
摆	bdqi
咙	lsrp
就	jqyu
嗖	szre
殂	cumm
枝	vide
杀	uakd
怔	vgpm
髓	svbb
革	getj
韩	hjjs
礼	liiu
一	yimm
千	qmhj
梯	tidh
友	yzke
蓝	ljtt
尘	iffg
疑	yipo
畀	biwl
揉	rzqd
蕞	zvte
邦	bhql
换	hrqk
翮	hemm
扭	nqqg
软	rrko
蚋	rvlb
粮	llfv
誊	tgfr
耄	mcju
显	xmac
游	yzed
邵	ucsl
邂	xpyq
畹	wjwu
哝	nsrv
恝	jxqp
酋	qqtm
库	kuiq
批	piqp
噔	dgrt
焖	mffp
蹼	puro
握	woqg
抗	khqn
聂	npse
歉	qmho
抃	bmqy
购	gzbi
姥	lcvp
嫩	nfvk
怦	pgpj
醐	humb
侗	dsor
癞	ldko
闰	rylg
佃	tmow
觜	zvyq
古	gujr
厚	hzmd
喏	norr
缞	cvvv
蟛	pglh
胳	gebr
律	lvhq
桷	jtdq
锃	zgog
御	yuhl
衩	iali
乐	ythd
狍	pcku
昶	ihia
封	fggi
兑	dvcu
协	xpjc
鞣	rztd
蹶	jtro
椽	irdo
炭	tjuf
苕	tntr
偡	vjov
瓮	wgcn
享	xlyd
挑	tnqo
喔	oorg
夯	hhks
貆	hrbm
侦	vfoo
紧	jblf
倒	dcon
莝	cotg
峡	xxut
蔗	vetf
猫	mckw
埂	gggk
疯	fgkk
抽	izqw
留	lqhw
命	mkol
夜	yeyk
鹰	ykim
呒	omru
吮	uyru
驺	zznm
枰	pkdj
创	ilon
展	vjsv
𬟽	dsld
谮	zfia
缝	fgvj
镝	diob
幽	yzui
圈	qrwu
日	riaa
揶	yeql
晷	gvar
辽	lnyn
印	ybhl
薄	boti
坊	fhgs
关	grtk
鳔	bnnf
巉	ijui
披	piqe
缴	vovk
嗤	iiri
疣	yzku
呦	yzrs
揣	ikqb
穹	qsjn
顺	uylo
埃	aigk
莓	mwty
嬥	tnvg
龌	woyg
囤	tywu
唇	iymr
牛	nqhq
肥	fwbu
乘	ighp
谋	mzid
挖	waqn
借	jpoa
产	ijyh
蛉	lkll
骗	pmnb
肆	sisq
喔	worg
耦	ouqb
峭	qnub
萏	djtx
上	uhym
陉	xknm
浪	lhev
噶	garv
瓞	dpho
么	mehi
餮	tpmv
差	iatm
唷	yorb
碾	nmmv
怩	nipp
绖	dpvg
块	kkgk
㬊	hrae
螂	lhll
蒈	kdta
所有	soyz
量	llag
娌	livg
祾	lkme
貊	moba
吻	wfrh
虽	svri
钏	irol
斟	vftj
琶	pamu
糠	khfe
草	cctj
玛	mamm
捏	npqg
耻	iism
呔	tdri
乓	phoi
画	hxmw
函	hjue
𨺙	ninu
灾	zdjf
霎	uamv
蜒	yjlm
酋	qqcw
从	csoo
鳄	eens
蚺	rjlb
噙	qbrb
嵖	iaum
瞿	qubg
辎	zikw
兵	bkoc
鄱	pohl
獍	jkku
彘	vivp
痕	hfkv
妊	rfvg
纯	iyvu
解	jpnq
妖	ycvk
鹩	lnkm
村	cydi
边	bmys
红	hsvm
段	drhe
捋	lvqi
姓	xkvm
闷	mflp
铩	uaod
巽	xysc
髹	xqsd
倬	vooj
唤	hrrk
擐	hrqv
酷	kumr
缱	qmvr
鬃	zssf
仰	yhol
镀	duoe
筐	klhg
嵘	rsud
否则	fzze
殡	bbmc
猝	cukj
荤	hytq
镧	ljow
矻	kumn
鲒	jpnr
锞	keod
畴	izwi
宦	hrjl
岛	dcpu
失	uiho
喳	iarm
耠	hoqr
广	glyh
稣	sund
篡	crhi
伯	booa
谣	yciu
处	iuho
鹃	jrrm
宪	xmju
裎	iglg
陪	pwnr
慨	kdpu
窑	ycju
矍	jtbe
烙	lofr
尺	iiso
椒	jnde
唯	wwrg
嚯	horg
迁	qmyj
穴	xtjc
迫	poya
韶	ucyr
姈	lkvl
嫖	pnvf
锡	xioh
窝	wojb
觉	jtfu
弊	bift
冥	mkbc
狞	nkkn
贾	jxmo
便	bmok
巴	baau
纩	klvi
鲹	ufnh
忘	whyp
脐	qibl
珣	xyma
髅	lzbv
鼠	uuhv
尹	ybsk
婳	hxvw
动	dsms
旻	mbak
称	ifhf
陂	pone
窎	dnjm
粗	cufm
新	xbyl
菜	cdtd
崔	cvug
刚	ghbn
肯	kfyb
衷	vsyv
乔	qnhl
睁	vgbd
茄	qptr
鲧	gynf
纻	vuvm
贸	mcho
翱	aohm
难	njeg
酢	zoms
栓	urdg
再	zdmb
赃	zhbg
蒽	entp
绘	hvvi
除	iund
收	uzvk
佻	tnoo
肿	vsbl
霈	pwmb
慢	mjpe
率	lvyj
裴	pwlv
鳑	phns
鹘	gubm
痄	vaks
罚	fawn
怪	gkpg
茝	idtl
尬	gakl
魁	kvhj
沐	mued
碰	pgmc
褶	vela
氪	keou
剌	ladn
况	klmu
表	bnqv
呶	ncre
改	gdsk
汹	xsek
卦	gxgy
霍	homg
岩	yjur
聊	lnsl
单	ijcj
歃	uamo
欧	ouso
铮	vgod
野	yewn
奴	nuve
炳	bkfb
寡	gxjh
又	yznk
俺	anov
燃	rjff
乱	lrhu
肋	lwbs
讯	xyij
蹅	iarm
哭	kurk
兰	ljtm
儆	jkok
赐	cibh
盆	pfct
嗜	uira
冗	rsbu
喆	vegr
蝾	rsld
贱	jmbj
焊	hjfj
磷	lbmq
修	xqoh
叶	xprj
岵	huur
绽	vjvo
撸	luqa
源	yref
戳	iosi
胈	babk
狗	gzkr
膳	ujbr
鲛	jnnk
风	fghk
扑	puqy
祃	maim
惴	vvpb
店	dmir
堕	dong
荄	gdto
岑	cfun
铿	kgog
蒌	lztv
聪	cssp
缮	ujvr
隙	xinf
方	fhys
函	hjme
吹	ivro
烽	fgfj
酡	tomp
酒	jqew
咳	kero
凑	czik
烤	kcfs
蘅	hgtn
碰	pgmm
罢	bawi
抵	diqi
兮	xics
最终	zvvs
吼	hzru
锛	bfot
羹	ggtk
吞	tymr
箴	vfhr
祝	vumu
粘	nmfr
形	xkmh
踮	dmrr
挣	vgqd
哼	hgrn
谬	mqih
扬	yhqh
内容	nwrs
智	vioa
待	ddhi
嬬	ruvb
𥕢	ccma
云	yymi
松	ssdi
弓	gsnn
屼	wuuu
枪	qldu
劢	mdms
唰	uxrn
啕	tcru
争	vgnd
楯	uydu
獭	tako
砟	vams
蹬	dgrt
崖	yaug
哉	zdjr
厩	jqmu
腾	tgbm
纥	gevn
还	hryf
钩	gzoi
檬	mgdo
勋	xyrs
骖	cjnh
倦	jrou
落	latr
得	dwhi
靴	xttp
与	yuym
煃	kvfg
瑢	rsmr
丞	ignm
遛	lqyw
宙	vzjw
纨	wjvi
累	lwwf
万	wjms
遨	aoyk
爽	ulkk
瑞	rvmb
嗦	sorf
堽	ghgm
缺	qtok
濉	sveg
促	cuoo
缥	pnvf
葜	qxtk
世	uipt
测	ceen
嗨	hdry
贫	pbco
氕	ppol
鳊	bmnb
麾	hviu
荽	svtv
堂	thfg
塝	bhgs
丫	yacl
奸	jmvj
厢	xlmu
柘	vedr
调	tnir
愃	xrpm
懊	aopk
傲	aook
塅	drge
圪	gegn
沌	dyeu
辏	czkk
鲮	lkne
重	vshg
众	vsoo
孜	zink
耢	lcqs
肮	ahbn
鲰	zzne
劳	lcts
安	anjv
鳞	lbnq
笮	zohs
胱	glbu
反	fjme
跺	dord
婼	rovr
萚	totq
陬	zzne
但	djom
垃	lagt
络	lcvr
燮	xpfe
嫱	qlvw
擦	caqf
坌	bfcg
者	veja
嶝	dgut
脉	mdbe
疔	dkkn
㬚	ieak
栏	ljdm
饭	fjne
亢	khyn
峥	vgud
江	jlem
蜡	lala
猜	cdkb
屉	tist
沈	ufeu
帱	dcli
轴	vzkw
鲘	hznr
囱	cshi
狂	klkg
贵	gvlo
巽	xyrc
啜	iore
绔	kuvs
绍	ucvr
昊	hcak
睡	uvbm
硐	dsmr
趱	zjgo
帷	wwlg
腋	yebk
福	fuiw
蜈	wulk
熔	rsfr
疲	pike
颇	podo
厌	yjmk
媛	yrve
庶	uuif
县	xmbi
狲	sykf
嗒	tarr
倮	lood
否	fzmr
操	ccqd
证	vgim
禀	bkyf
嵯	coum
鲲	kynp
卖	mdjk
惠	hvjp
婻	njvj
鲜	xmnq
通	tsyb
苦	kutr
关系	grxi
瘳	izkh
顶	dkmo
蚣	gsli
摧	cvqg
摞	loqf
指	viqa
赖	lddo
十	uijj
横	hgdc
威	wwiv
钯	baou
尾	wwsu
替	tiqa
禁	jbdf
销	xnob
企	qiom
赡	ujbr
骇	hdno
况	kliu
芘	pitp
嗯	ogrp
黾	mbrv
纱	uavh
嗝	gerb
破	pome
开	kdmt
咋	zars
炼	lmfc
政	vgmk
棍	gydp
别	bprn
蹙	cuio
绿	lvve
麻	maic
祚	zoms
颤	ijyo
裁	cdjv
学	xtfd
亩	muyw
峰	fguj
鸽	geom
重	ishg
桡	rcdu
卡	kayy
旁	phys
硿	ksmm
组	zuvm
舔	tmmp
夹	jxkt
憨	hjnp
坟	ffgk
柴	idyd
芸	yyti
喊	hjrr
浭	ggek
结	jpvr
岚	ljuk
彪	bnyh
撄	ykqv
嘚	deri
忽	hupp
炝	qlfu
邈	mnyu
逆	niyu
龋	quyb
狩	uzki
内	nwob
瞻	vjbr
齐	qiyl
龊	ioyo
谤	bhis
猡	lokn
拉	laqt
茛	gftv
娜	novl
帐	vhlo
粥	vznn
早	zcaj
涝	lces
躔	ijrg
斯	sitl
旒	lqyv
弹	tjnj
柏	boda
蹚	thrg
婵	ijvj
缚	fuvi
嫡	divb
诟	gzir
雏	iung
襁	qlli
斌	bbym
赈	vfbv
着	vetu
隘	aint
飞	fwno
黄	hltc
玶	pkmj
啾	jqrf
蓓	bwtr
蛃	bklb
甦	summ
皖	wjhu
䏝	vrbi
搞	gcqb
蝴	hulb
落	lotr
泥	niep
裙	qylr
鲗	zwnn
怄	oupk
箩	lohn
祊	bgis
腊	laba
搠	uoqb
璨	cjmd
钉	dkon
故	gujk
模	modk
柊	vsdm
爨	crhf
扉	fwhy
责	zeqo
恻	cepn
非	fwly
割	gejn
堡	buog
袅	nnpv
狮	uikb
雇	gumg
瞬	uybq
差	idtm
椰	yedl
砣	tomp
祖	zuim
篝	gzhb
肋	lebs
伧	ifou
娱	yuvk
茹	rutr
规	gvqu
畅	ihlh
度	doie
疟	ntkm
袄	aolk
转	vrki
样	yhdq
崁	kjuo
鲵	ninu
崤	xnub
啥	uarr
陛	bing
妭	bave
秭	zihh
髽	vxsg
穑	sehw
伢	yaoh
蚂	malm
炫	xrfi
牤	mhhv
唐	thir
毁	hvhe
洘	kces
酬	izml
爪	vcho
苑	yrtu
橐	tojd
果	gowd
奋	ffkw
逢	fgyj
好	hcvd
货	hooo
确	qtmg
浓	nsev
阙	qtlo
他	taod
阳	yhna
敛	lmok
逮	ddye
青	qkqb
茑	nntm
牟	mziq
娜	navl
飒	sayk
滤	lvep
料	lnfj
岫	xquw
朴	pudy
崃	ldut
丛	csom
摒	bkqj
婢	bivj
态	tdkp
厦	uame
埙	xygo
鄀	rotl
私	sihi
噤	jbrf
惰	dopb
馆	grnr
褐	helv
锹	qnof
茼	tstr
赘	vvqo
位	wwot
匍	pupb
耪	phqs
彟	hose
瓤	rhyo
陀	tonp
前	qmtn
扉	fwiy
萳	njtj
臀	tysb
聚	juso
玲	lkml
俩	lxob
曩	nhav
彖	trvo
示	uimf
晫	voaj
墉	ysgb
防	fhns
抬	tdqr
社	uemg
足	zuro
教	jnjk
憋	bpfp
蹂	rzrd
业	yetc
耋	dpjg
孺	runb
迩	eryf
镆	mook
螬	ccla
苄	bmty
菲	fwty
姮	hgvm
蛮	mjyi
耽	djsu
霾	mdmg
片	pmln
波	boee
跄	qlru
𬒈	qtfr
海	hdey
乜	nppn
扒	paqc
霭	aimv
箜	kshm
情	qkpb
亥	hdyo
𪨶	ueuq
尸	uiss
跋	bark
话	hxir
毋	wuwj
瞥	ppfu
谓	wwib
帻	zelo
维	wwvg
逡	qyye
尼	nisp
童	tsyg
贤	xmlo
媪	aovt
逼	biyw
步	buyh
目录	mulu
烃	tkfm
谦	qmic
㟃	siur
我	wohi
陈	ifnd
妁	uovm
戈	geii
或	hoim
肠	ihbh
腘	gobi
桧	hvdi
贷	ddoo
朝	icjb
嗵	tsrb
拎	lbqi
队	dvno
橙	igdt
微	wwhk
薮	sztk
期	qitb
嫒	aive
存	cykd
帑	thvb
鬓	bbsc
曾	cgca
藏	zhts
集	jiod
聘	pbss
刿	gvun
钛	tdoi
呜	wurm
阗	tmlc
算	srht
羡	xmto
嶟	zyui
顿	dypo
宝	bcji
乖	gkhp
尊	zyti
硭	mhmv
巅	dmuo
讷	neib
敌	dihk
井	jktt
秕	bihp
佩	pwob
跋	bare
捆	kyqd
摄	ueqe
藤	tgte
嗓	shrd
绀	gjvm
屯	typu
觥	gsnu
攥	zrqf
欲	yuco
倘	thor
膛	thbg
舟	vzhl
情况下	qkxx
锟	kyop
阐	ijlj
射	uehi
舍	ueor
瀼	rhev
忪	sspi
唱	ihra
孩	hdno
便宜	pmyi
嚼	jnri
哦	oori
墨	mowg
薤	xptm
嘴	zvrb
沃	woek
菊	jutd
昆	kyap
侔	mzoq
髯	rjsb
璒	dgmt
埆	qtgq
题	tiao
则	zebn
逍	xnyb
国	gowi
𩾌	khne
脂	viba
怍	zops
畈	fjwe
悍	hjpj
斋	vdyl
藕	outb
晌	uhar
柰	nddf
声	uggh
赵	vcgk
觜	zvyg
胛	jxbl
恶	eemp
她	tavd
玷	dmmr
桷	jtdg
凌	lkie
锿	aiov
侬	nsov
馕	nhnv
臣	ifsl
嚅	rurb
𫐓	rzkd
境	jkgu
泖	mcel
拐	gkqs
略	ltwr
痤	cokg
邡	fhyl
鲑	xpng
淫	ybeg
键	jmoq
绥	svvv
垕	hzhg
怆	ilpu
惜	xipa
满	mjeb
省	ugfu
镭	lwow
佞	nkov
然后	rjhz
砖	vrmi
叙	xuoe
瑾	jbmm
元	yrmu
醢	hdmt
斥	iihy
䎃	rjgm
点	dmyf
济	jiel
躲	dohd
和	hehr
蔡	cdtf
瘭	bnkf
赳	jqgl
鹭	lurm
棱	lkde
栩	xudm
昪	bmat
坰	jsgr
扉	fwmy
矰	zgoa
猊	niku
茕	qstj
禄	luie
母	muwi
困	kywd
呈	igrg
屋	wusg
籁	ldho
催	cvog
辨	bmyj
剃	ticn
毛	mchu
买	mdnk
勾	gzpi
芯	xbtp
保	bcod
筠	jyhm
楠	njdj
刊	kjmn
秉	bkhl
末	modj
虾	xxly
闳	hsli
慷	khpe
鲐	tdnr
𨱔	zyoi
嗄	uare
谩	mjie
剩	ughn
孤	guno
房	fhis
能	ndip
树	uudi
歹	ddmi
氓	mgyp
捞	lcqs
瑙	ncmw
嵌	qmuo
狷	jrkb
隔	genb
灵	lksf
旭	xuka
悦	ytpu
罨	yjwv
挝	vxqi
负	funo
刀	dcsh
晓	xnau
得	dehi
铘	yeol
赣	gjyo
自动	zids
床	ilid
匮	kvso
呣	omri
瘰	lokf
枉	whdg
娉	pkvs
细	xivw
需	xuml
爵	jtbi
这	vwyk
硇	ncmk
瑭	thmr
梦	mgdi
签	qmhm
痉	jkkm
吖	aarl
蔫	nmtf
聆	lksi
翟	vdsg
毒	duqi
船	irhr
痴	iikr
扪	mfqs
纽	nqvg
恰	qxpr
垌	tsgr
岽	dsud
薄	bcti
儋	djor
若	rotr
抓	vxqo
血	xpht
锗	veoa
妙	mnvh
鞧	qqtw
泐	lees
讳	hvis
力	liks
扂	dmhr
镴	laov
匿	nisr
圹	klgi
轮	lykp
菇	gutr
余	yuod
淮	hkeg
逗	dzyt
孙	synf
葛	getv
忧	yzpu
静	jkqd
煓	trfb
亚	yamc
亨	hgyn
锁	sooo
衮	gyyv
侯	hzok
坨	togp
麦	mdqe
餐	cjyv
颧	qrto
仆	puoy
来	lddt
狐	huko
鹅	eehm
饵	ernj
酱	jllw
辙	vekk
纲	ghvk
隩	aonk
评	pkij
钿	tmow
貅	xqbd
绵	mmvb
𧿹	muri
寒	hjjy
呼	hurd
娩	mmvu
酚	ffmh
狴	bikg
莰	kjto
校	xndk
嘈	ccra
纥	hevn
燎	lnff
吉	jigr
懵	mgpu
师	uilb
昶	ihma
矮	aiov
呛	qlru
埚	gogb
许	xuij
芫	yjtu
忍	rfsp
积	jihc
佗	toop
耶	yesl
蒎	pdtv
用	ysbq
尕	ganf
剂	jiyn
媲	pivp
玎	dkmn
姱	kxvs
朴	pndy
瞟	pnbf
追	vvyr
捧	pgqq
铐	kcos
瞅	izbf
储	iuoa
肃	sull
攀	pjdq
盐	yjgt
下	xxmy
罗	lowi
涅	npeg
纳	navb
葫	hutb
猖	ihka
稔	rfhp
忒	tvip
烘	hsfc
填	tmgc
策	cehb
叉	iaei
雯	wfmk
缨	ykvv
侃	kjou
摒	bkqt
绳	ugvu
恃	uipi
走	zzgo
扰	rcqu
索	sojf
鳁	wfnt
瞎	xxbr
鲟	xyni
丁	vgmn
羧	sote
类	lwfk
伽	qpor
绑	bhvl
犷	glki
孖	mand
倾	qkoo
娥	eevi
跤	jnrk
侣	lvor
缀	vvve
鸵	topp
伽	gaor
址	vigm
川	irll
这	veyk
憎	zgpa
杰	jpdf
虫	isli
蒜	srtf
斤	jbhl
雱	phms
啃	kfrb
昏	hyha
仔	ziod
砸	zamb
缭	lnvf
琇	xqms
迸	bgyt
搁	geqr
佛	foon
拷	kcqs
昃	zeao
督	duyu
片	pmll
迈	mdys
哥	gemr
估	guor
缴	jnvk
镛	ysob
叹	tjre
泵	bgme
趁	ifgh
颃	hhyo
华	hxoj
传	vroi
蔑	mptm
酿	nlmv
挲	soeq
剥	bonn
丢	dqhi
葑	fgti
咪	mird
赌	duba
鳀	tino
氲	yyot
蟠	pjlw
理解	lijp
却	qtgl
渲	xrem
双	ulee
作	zoos
亭	tkyn
跚	ujrt
崴	wduv
蛞	kolr
弄	lsmt
瘤	lqkw
缪	mqvh
碡	vzmh
僧	sgoa
脸	lmbm
鲾	binw
镬	hooe
蔸	dztu
篓	lzhv
抡	lyqp
馒	mjne
拽	vkqp
𫔶	npld
踹	ikrb
脞	cobg
蜿	wjlu
东	dskd
喋	dprd
陶	tcnu
钙	gdos
跚	ujrm
暧	aiae
丰	fgqj
筇	qshl
遄	iryb
旵	ijau
弄	nsmt
剥	bcnn
硕	uomo
倌	gror
哿	gekr
萄	tctu
偌	roor
梢	ucdb
堽	ghgv
锐	rvou
艺	yitn
槽	ccda
祋	dvie
判	pjfn
萨	sath
史	uilk
屏	pkst
宏	hsji
帽	mclu
论	lyip
限	xmnv
龈	kfyv
侠	xxot
弧	huno
腻	nibo
止	viym
晙	jyae
鬼	gvhi
乍	vaos
旋	xryo
鬏	jqsf
僵	jlom
玩	wjmu
昙	tjai
病	bkkb
湾	wjen
哟	yori
垓	gdgo
礞	mgmo
杩	madm
遮	veyf
蹉	corm
钥	ycob
喷	pfro
酞	tdmi
蓬	pgtj
犒	kchb
烙	lcfr
某	mztd
瞩	vubb
陋	lznv
控	ksqm
杜	dudg
透	tzys
膘	bnbf
卧	wosy
盹	dybu
尖	jmfk
扽	dfqu
砂	uamh
琳	lbmd
噂	zyri
鲏	pine
啷	lhrl
祚	zois
祧	tnio
套	tcki
想不到	xbdc
烛	vufi
熘	lqfw
增	zgga
路	lurr
啄	voro
乾	qmjn
靸	sate
无	wumu
傀	kvoi
兆	vclo
呆	ddrd
蔺	lbtg
囵	lywp
擞	szqk
砍	kjmo
昂	ahal
畜	iuyw
袭	xiiv
钡	bwoo
岿	kvus
汕	ujeu
饪	rfng
壁	bisg
溺	nnem
胎	tdbr
叟	szhe
逻	loyn
掘	jtqu
嶙	lbuq
腨	urbb
赅	gdbo
堆	dvgg
珠	vumd
囱	cshe
铤	tkog
蠖	hole
棉	mmdb
瘙	scki
炔	qtfk
尧	ycju
变	bmye
芎	xstn
苛	ketr
辣	layl
描	mnqw
穷	qsjs
溲	szee
棣	dide
紫	ziyf
蓄	xutw
门	mfls
涉	ueeh
鲁	luna
萘	ndtf
恒	hgpm
熟	uuyf
饱	bcnu
吭	hhrn
融	rsmi
慌	hlpv
爷	yecl
优	yzou
肉	rzoo
闹	nclb
祝	vuiu
桓	hrdm
簖	drhl
掭	tmqp
求	qqie
沌	vreu
镯	vooi
叶	yerj
刷	uxsn
碹	xrmm
吭	kgrn
聒	gosr
鞠	jutd
种	vshl
噢	oork
荪	sytf
照	vcaf
窗	ilje
禤	xrmm
糌	zjfa
斡	wojj
商	uhyr
降	xlnq
面	mmml
务	wuhs
月	ytbb
忒	twip
铄	uood
寒	hjjm
时	uiai
昕	xbal
滩	tjeg
掴	goqi
菹	zutm
铳	isou
鸭	yawm
膙	jlbi
荏	rftg
𬭎	hsoi
睿	rvyu
蹲	dyri
酂	cohl
短	drot
炊	ivfo
曾	zgca
夼	klkl
鲅	bane
藻	zctd
町	dkwn
涩	seem
和	hohr
场	ihgh
纠	jqvl
瞪	dgbt
梃	tkdg
臃	ysbg
羸	lwyq
崽	zdup
汭	rveb
裒	pzyv
褒	bcyv
掠	ltqf
琢	vomo
惘	whpv
岷	mbup
条	tnhd
款	krgo
爹	dpcn
煦	xuaf
膜	mobk
快	kkpk
犯	fjku
鸟	dnpm
馞	bohd
缠	ijvg
投	tzqe
犏	pmhb
靶	batu
驷	sinc
慝	tesp
臭	izhk
弱	ronm
侧	ceon
绗	hhvn
裢	lmlq
彼	bihe
厥	jtmo
嗷	aork
儡	lwow
伐	faoi
猹	iakm
悄	qnpb
平	pkmj
环	hrmf
胈	babe
暅	ggam
溆	xuee
糍	cifi
韬	tcqx
挽	wjqu
飘	pnmk
尝	ihfi
溃	kveo
堑	qmkg
杷	padu
瞰	kjbk
琴	qbmn
颔	hjoo
掀	xmqo
迮	zeys
比较	bijn
歧	qiye
获	hotk
塌	tagm
胥	xunb
是	uiao
忽略	hult
淙	csef
乡	xlvh
睬	cdbd
搀	ijqy
嵋	mwuu
曛	xyaf
跷	qnru
衷	vsjv
檎	qbdb
陂	pine
裂	lpmv
俗	suor
抹	moqj
阇	uela
𦝼	lvbv
附	funi
石	uimr
模	mudk
辗	nmkv
锥	vvog
顾	gumo
祀	siiu
邛	qsml
徒	tuho
括	koqr
镗	thog
胖	phbq
嘭	pgrh
纺	fhvs
思	siwp
那	nwsl
氛	ffoh
珐	fami
峨	eeui
鹌	ankm
碟	dpmd
篑	kvho
徽	hvhk
胴	dsbr
毯	tjhf
可以	keyi
龙	lsip
俄	eeoi
回	hvwr
侗	tsor
天	tmmk
戴	ddjc
晴	qkab
秃	tuhn
嬛	hrvv
发	faie
幢	illg
奡	aoml
体	tiom
莜	yztk
莲	lmtq
冗	rsbn
倔	jtou
豇	jlmm
泌	mieh
枫	fgdk
器	qirr
眼	yjbv
程	ighg
捐	jrqb
勒	lets
凭	pkon
儒	ruob
泛	fjeo
廉	lmic
啮	npru
痘	dzkt
裱	bnlv
鲦	tnnd
够	gzpn
穰	rhhv
庵	aniu
鬈	qrsu
谪	veib
媾	gzvb
筘	kzhr
艘	szhe
麝	ueii
闻	wflj
真	vfjc
泼	poee
獾	hrkg
狯	kkki
所	soml
迥	jsyr
两	llmb
璲	svmo
定	dkjo
挎	kxqs
熬	aoqf
笳	jxhr
逄	phyq
且	qpbm
栊	lsdp
貉	hebr
讴	ouik
炽	iifc
扣	kzqr
裤	kulq
啪	para
碡	vzmj
斩	vjkl
尴	gjkt
烝	vgnf
袁	yrgv
车	jukq
泪	lweu
唔	onrr
攒	zjqo
裾	julr
像	xloo
鲽	dpnd
嗅	xqrk
葱	cstp
厝	coma
埆	qtgg
擤	xkql
包	bcpu
饿	eeni
鞳	tatr
泯	mbep
仂	leos
袼	gelr
禤	xrim
篾	mphi
蒋	jlti
崇	isuf
绮	qivr
琫	bgmq
大概	dagd
喻	yurn
打	daqn
鸢	yrim
囷	qywd
丈	vhjk
甭	bgmq
柠	nkdn
嘎	gari
梭	sode
艾	aitk
提供	tigs
徘	pdhy
蓑	sotv
椿	iyda
押	yaql
涓	jreb
察	iajf
铉	xroi
瞒	mjbb
祟	svuf
赊	uebf
眍	kzbk
停	tkon
怎	zfop
导	dcri
耧	lzqv
堍	tugi
鳝	ujnr
感	gjip
壳	qngn
叨	dcrh
特	tehi
慆	tcpx
籥	ythb
尔	ernf
坝	bago
棚	pgdb
奈	ndkf
浩	hcer
仄	zemo
鲙	kkni
明	mkab
嶒	cgua
惹	retp
埋	mdgg
萝	lotn
鳇	hlng
踝	hkrd
䲠	iyna
矿	klmi
抵	diqm
正	vgmm
叠	dpem
顷	qkpo
苏	sutc
凝	nkio
金	jbcc
昱	yuat
飙	bnik
座	zoig
绠	ggvk
罨	yjwu
诱	yzis
巧	qnms
莼	iytu
装	vllv
情况	qkkl
它	tajp
驵	zhnm
册	cebm
楦	xrdm
桶	tsdb
搌	vjqv
忖	cypi
辰	ifmv
蓼	lnth
躇	iura
速	suyl
镚	bgob
拦	ljqm
蔈	bntf
蔽	bitk
脓	nsbv
鳓	lens
普	puta
三	sjmm
朽	xqds
阿	aanr
哌	pdrv
舞	wuoq
秘	mihh
骚	scni
蝼	lzlv
霸	bamb
剿	jnvn
毒	duqh
澳	aoek
扂	dmir
髋	krbu
缄	jmvr
跎	torp
征	vghm
疼	tgkm
盔	kvkt
檑	lwdw
抢	qlqu
搭	daqr
火	hoff
跳	tnro
桩	vldg
皈	gvhe
崂	lcus
荩	jbty
靠	kchy
哪	nerl
帔	pwle
彻	iehh
蒡	bhts
婚	hyva
舛	irnq
悛	qrpe
艚	ccha
压	yami
卑	bwhj
乐	lehd
仨	saom
瘫	tjkg
纶	grvp
媆	rrvk
败	bdbk
于	yumd
苟	gztr
氦	hdoo
敬	jktk
筒	tshr
戎	rsij
㑇	vzom
魍	whhv
弢	tcne
赞	zjho
盥	grht
萱	xrtm
狻	srke
铃	lkoi
李	lidd
曷	heao
廿	nmtt
递	diyh
只	virc
概	gddu
埔	pugb
攘	rhqv
凼	dhue
妾	qpyv
怕	papa
抿	mbqp
涮	uren
仟	qmoj
脏	zhbg
持	iiqi
瞄	mnbw
链	lmoq
美	mwtk
惙	iope
阵	vfnq
黑	hwwf
出	iuuu
姗	ujvm
董	dstg
氢	qkom
弘	hsni
惯	grpo
不	bumf
炼	lmfd
宸	ifjv
苒	rjtb
矼	ghmm
升	ught
擀	gjqj
建	jmnq
旷	klai
陲	ivnm
𦰡	notl
地	digd
宁	nkjn
如	ruvr
赎	uubk
慈	citp
璈	aomk
莱	ldtt
讽	fgik
茶	iatd
蹑	npre
八	baho
斓	ljyw
倜	tior
窗	iljk
奇	qikr
痛	tskb
绸	izvr
费	fwlo
奘	zhvk
憨	hjmp
溟	mkec
秾	nshv
愣	lgps
辊	gykp
偏	pmob
徙	xiho
苔	tdtr
生	ughm
腙	zsbf
蔓	mjte
衄	nvhg
拼	pbqt
怏	yhpk
贺	heko
贬	bmbo
趋	qugm
谱	puia
圭	gvgg
铣	xmou
蛤	gelr
灌	greg
璮	tjmm
嘱	vurb
沦	lyep
琐	somo
踉	llrv
您	nbop
腭	eebs
夹	gakt
瘌	lakn
荡	dhth
嗲	dxrn
伉	khon
嫚	mjve
侘	iaop
巷	hhtu
缂	kevj
军	jybq
宠	isjp
枣	zcdy
扼	eequ
缎	drve
常	ihfb
卅	satj
劄	vahn
欻	ixfo
铪	haor
窊	wajo
溜	lqew
肫	vybu
歇	xpao
莴	wotb
地	degd
洞	dser
穆	muhh
绲	gyvp
猴	hzkk
抱	bcqu
唛	mdre
怜	lmpi
低	diom
绉	vzvm
缇	tivo
璠	fjmw
锕	aaor
复杂	fuza
歉	qmto
课	keid
吕	lvrr
玲	lkmi
祖	zumm
晃	hlau
唠	lcrs
趯	tigg
寇	kzje
穙	puho
谶	ifim
馍	monk
珊	ujmm
拥	ysqq
㠓	mguo
赭	vega
匦	gvsn
蝶	dpld
本	bfdm
很	hfhv
劣	lpfs
简	jmha
睐	ldbt
嘲	vcrb
鸸	ermm
婉	wjvu
戗	qloi
龀	ifyp
谙	ania
往	whhg
汉	hjee
然	rjbf
孬	ncmd
续	xuvk
卫	wwsm
珊	ujmt
电	dmlu
狼	lhkv
捩	lpqk
缵	zrvo
浜	bhec
踪	zsrf
岜	bauu
薛	xttj
绺	lqvr
莞	wjtu
剋	kwjn
甜	tmhm
右	yzkr
嘬	zore
熥	tgfb
影	ykah
柏	bdda
鬟	hrsv
鲢	lmnq
旸	yhah
泽	zeeq
丘	qqom
显示	xmui
愧	kvpi
当	dhfm
獐	vhkj
播	boqw
壬	rfmg
喵	mnrw
岳	ytou
噪	zcrd
先	xmhu
怯	qppi
做	zook
呐	nerb
窃	qpjh
告	gchr
涔	cfen
啐	cvrj
浑	hyeq
喏	rerr
蒸	vgtf
菱	lkte
艮	gfav
脎	sabc
绯	fwvy
刨	pcpn
阴	ybnb
伤	uhos
祾	lkie
沓	daea
守	uzji
珈	jxmr
粼	lbfv
朋	pgbb
休	xqod
莎	uath
投资	tzzi
拟	niqo
尿	nnse
最	zvae
咩	mprq
裆	dhlm
视	uiiu
鳏	grnf
㻬	tums
腿	tvbv
睾	gchj
裰	dole
蹭	cgra
挡	dhqm
搔	scqi
髦	mcsu
炉	lufs
公	gsci
漭	mhet
雅	yamg
楚	iudo
撩	lnqf
埽	scgb
键盘	jmpj
关	grck
厂	ihmh
擅	ujqm
身	ufhh
茨	cito
群	qysq
层	cgsi
𨟠	qrbl
歉	qmco
桁	hgdn
㧐	ssqe
