𱞌	hxpa
偯	yioa
餏	yiof
𥴨	aiha
𫂖	aihb
雸	anmd
𩹎	annc
鼇	aogd
𩘮	aoqd
𧺺	baga
叐	baha
秡	bahb
颰	bahc
馛	bahd
鼥	bahg
𩖽	bahh
𩙥	bahj
𥝧	bahm
𦫙	bahn
㯽	bbda
梹	bbdb
𣰨	bbjd
璸	bbma
鸔	bcha
笣	bchb
𪏶	bchc
珤	bcmd
虣	bcmf
靤	bcmg
𨠖	bcmh
鞄	bctb
𦳞	bdta
𰬭	bgva
𨕧	bgya
睥	biba
䁹	bibb
肸	bibf
貏	bibm
𠧅	bibp
𩪖	bibq
𩪧	bibr
壀	biga
𠬈	bigc
𫎳	bigd
𩲢	biha
𥟗	bihi
𦤫	bihm
𤢣	bika
𤹝	bikb
𧏻	bila
𧓄	bilb
𬠃	bilf
鄪	bilm
𨚓	bilq
𰻳	bilr
禆	bimb
豍	bime
𥛘	bimg
彃	binb
𮩛	binc
嗶	bira
蹕	birb
躃	birc
𠮃	bisg
𦰙	bita
𣦇	biya
辨	bjyf
辯	bjyk
辬	bjyl
𨐱	bjym
𫚎	bkna
𣩀	bmme
𡬸	bmva
𬸸	bmyc
㦚	bmyd
㵷	bmyg
辡	bmyk
辧	bmyl
𤀲	bmym
𦠎	bnbb
𰷫	bnbc
𩗓	bohf
𫗈	bohh
犦	bohj
䳁	bohl
秡	bohp
箥	bohq
馛	bohr
𦤚	bohs
𨈩	boht
𨏫	boja
𪍡	bojb
襮	bolc
蚾	bolf
袚	bolg
襏	boll
𤗳	boln
䙏	bolp
牔	bolq
𩄿	bomb
𠱀	bora
𫏆	borc
𥳖	buha
𧼠	bwga
𧉥	bwla
鄁	bwld
婇	cdva
𬢉	cija
黲	cjwa
𬢳	cjya
𪕝	cuha
臎	cvba
𧳚	cvbb
𦈘	dava
𪺣	dcla
𦦾	dcqa
𨓞	ddya
𥯕	dhha
𬛹	dhhb
𰩹	dhhd
𭫙	dide
虳	dila
𧉛	dilf
厎	dima
䂡	dimd
厎	dime
𰔇	diqa
羝	dita
䩚	ditc
茋	ditd
菧	ditl
靮	ditn
𩉱	ditq
嶳	diua
𡽢	diud
𥾬	diva
𥿄	divc
逓	diyc
遰	diyd
𨗼	diyh
𨘬	diyq
𰻆	diys
𨑼	diyx
𣯵	diyz
𩩧	djba
𢅒	djla
𩈊	djma
紞	djva
槙	dmdb
𩬑	dmsa
𥮐	dnha
𦨣	dnhb
𨦃	docc
𥿰	dova
𢎆	dpia
𩂓	dsmb
𥀲	dudb
𣫔	duga
𬢎	duja
𧁿	duta
𮏺	dutb
𡼻	dvha
𩕬	eeha
𩋊	eeta
𪘐	eeya
䌺	erva
㸮	ffha
秎	ffhe
躮	ffhg
馚	ffhi
𦦑	ffhj
𢓱	fghb
䲱	fhha
𥫳	fhhb
𪕃	fhhd
鐢	fjdb
𨟄	fjde
畨	fjfb
賻	fuba
𣑿	fuda
𡏪	fuga
𩒙	fuha
箙	fuhg
𥳇	fuhh
𥷱	fuhk
𦨈	fuhp
甶	fuhq
𦩡	fuhz
祔	fuia
禣	fuid
𤸑	fuka
𰺓	fukc
袚	fula
𧕡	fulf
𢂆	fulg
䘠	fulh
蚥	fulp
袚	fuls
𤝟	fult
乀	fumh
酜	fumj
畐	fuml
𱯧	fumq
払	fuqa
𢰆	fuqc
𦔍	fuqg
𩖬	fuqh
𩢿	fusa
蕧	futa
𦎭	futg
𧄏	futh
𩋟	futl
𰱦	futq
𦮹	futt
綒	fuva
𰬘	fuvj
紨	fuvp
𡠞	fuvq
𰬅	fuvv
𤱽	fuvx
𥪚	fuya
𧕿	fwla
𩇫	fwlb
餥	fwlj
䆁	gcha
皐	gchd
𥢐	gche
𧢌	gchg
櫊	gedc
𪌣	gede
𪃿	gema
𦚸	ggbc
𦞌	ggbd
骭	gjba
𪔆	gjbb
𣔼	gjde
𥸡	gjha
簳	gjhb
𦼮	gjta
欟	gldb
遦	grye
𦩼	gsha
皷	guga
皼	gugh
糓	gugi
轂	gugm
鼔	gugp
𣪸	gugt
𣫀	gugw
箛	guha
頋	gumd
詁	guyb
逧	guyc
𧆻	guyd
𧇡	guyk
𩏐	gvdb
𧻜	gvga
𥦣	gvja
𫋻	gvlh
𩲡	gvmb
𩳝	gvmh
𩳧	gvmj
𰧻	gvmn
摫	gvqa
𰓻	gvqe
𩊛	gvta
袬	gyya
皞	hcha
皥	hchd
皡	hchg
獔	hcka
噑	hcra
諕	hcyc
䶎	heha
秴	hehb
𥞍	hehh
𥘫	heic
𰵣	heie
鲄	hena
𠚔	henb
𡇶	henc
貥	hhbd
𧦑	hhya
𪗜	hhyb
𬹽	hhyd
䍑	hjba
䏷	hjbb
貋	hjbd
𩾝	hjha
𢃗	hjla
䁜	hlba
䐠	hlbb
皝	hlha
皩	hlhb
𨉁	hlhh
𡧽	hlja
愰	hlpa
𡡄	hlva
𥿪	hlvb
𧠬	hlvd
朚	hlya
詤	hlyc
𦨯	hoha
䄆	hoib
𩿊	hrba
𥈉	hrbb
𦝝	hrbd
䯘	hrbe
𧡩	hrbh
𥶍	hrha
𤽕	hrhb
𦼉	hrta
𥈿	hsba
𬮢	hsla
𨢣	hsma
𩒴	hsmb
𫩕	hsra
𦶓	hsta
𩒓	hstb
𩖉	hstg
枑	hudc
𣙶	hudg
𪍂	hudi
𢨦	huha
𥶜	huhk
𪕉	huho
𤭱	huja
𭘓	hule
𧠩	huta
𧢰	hutf
𧇛	huyb
𧦚	huyc
𨖃	huyf
𨛵	huyn
𨝘	huyq
𥶵	hvhb
𥸃	hvhd
𱈑	hvhg
𨍹	hvja
鮰	hvna
𫚔	hvnb
戱	hvyn
𧖢	hvyo
𦧵	hxha
崋	hxub
𨏂	hyjc
𤙽	hzha
査	iada
迠	ieya
𧿒	ifra
藽	ifta
檉	igda
𱴇	igma
𰬖	igva
𪄹	ihfb
𦞲	iibe
𰷢	iibf
䰡	iiha
𢔊	iihj
𦆤	iivf
歯	iiyf
𧩴	iiyh
𨖎	iiyl
𱌯	iiym
幨	ijla
袩	ijlc
𤗻	ijld
硟	ijma
𬡻	ijmb
𦈎	ijva
䜛	ijya
覘	ijyg
𧠛	ijyk
剙	iltb
𨘼	irya
䊰	iufb
蟵	iulb
𢅥	iulc
豖	iumb
𣢶	iumc
𥒭	iump
𧯩	iumq
𧰫	iumr
𩈤	iums
諔	iuyb
遚	iuyc
𣥹	iuyd
𣮢	iyyb
醻	izmb
𧃝	izta
𩤿	jbsa
𠞱	jbta
鷄	jibo
𤓑	jibs
𧡉	jibt
𦠄	jibv
𦠾	jibz
𦠄	jika
檵	jidf
𣛔	jidq
檝	jidw
𤿠	jiga
㧀	jihh
㹄	jihq
彶	jihs
鬾	jihw
𢃺	jihy
𢺼	jihz
𥰦	jiea
穄	jifd
鱀	jife
鷑	jifi
鸄	jifn
𪄵	jifp
卽	jilf
皍	jilg
𥫶	jilh
𰨦	jilm
𣣝	jiob
𨂢	jioh
秸	jirh
躸	jirm
𧫜	jirq
庪	jiib
𡫀	jija
𢼋	jijh
𥨿	jijs
瘈	jikg
𠫷	jikh
𧐐	jily
𧉍	jilz
𰳁	jioq
𥕂	jima
磯	jimp
禨	jimq
霵	jims
𥖙	jimv
磯	jimy
禨	jiko
㒫	jiuh
玘	jiul
𣯅	jiuo
𨻕	jinh
彐	jink
𢏞	jins
𨹶	jint
𧢾	jinw
𩧱	jinz
𣔽	jidy
𱇺	jidz
䣢	jiqc
𨜒	jiqd
㘍	jirs
嘰	jirt
𠿠	jirv
𢨐	jirw
喞	jiry
𠶻	jijv
𡃃	jijw
𡅺	jijz
𧾽	jiaa
𡳮	jisb
𨲪	jisd
𩯋	jish
𦾲	jitg
𧃞	jitt
鞿	jitw
𦺩	jity
𦺬	jiij
革	jiab
卙	jiad
𦎢	jiae
薊	jiai
蘮	jiaj
𦮯	jiak
𦺶	jial
𩉜	jiap
鞊	jiaq
𦆡	jiva
𧧩	jiyq
𧧟	jiyt
𨒴	jiyv
覘	jiyw
宑	jkja
𩰰	jkma
𩰹	jkmj
弳	jkna
陘	jknb
𢀖	jknd
𱉠	jkne
䜘	jkyc
𫽣	jlqa
𦩵	jmhd
筧	jmhe
𫀨	jmhk
鵳	jmid
𬣡	jmie
帴	jmlf
襺	jmlg
𰀢	jmlh
𨤄	jmme
𩆷	jmmg
𩇏	jmmh
𩉔	jmms
𫛚	jmmu
擶	jmqa
𡅶	jmra
𧂂	jmtg
𧂆	jmto
𧅆	jmts
𩋋	jmtt
𪏊	jmtx
𮶬	jmja
𬘖	jmvd
𣝞	jnde
湬	jnhd
𥳴	jnhn
敿	jnhp
斆	jnhq
笅	jnhs
筊	jnht
𪁉	jnhz
𪖄	jnka
𰕈	jnkb
𰩸	jnla
臫	jnud
𤉧	jnkc
𤶀	jnkf
𩵰	jnnc
𪚰	jnne
𱍆	jnng
𱇩	jnnm
𢯴	jnqa
𦅃	jnvm
𣙴	jpdb
𪌧	jpde
𣮍	jphb
𢷿	jpqc
𬝋	jptb
𪙏	jpyd
𫜯	jpyf
𫃗	jqfa
乣	jqva
𫄙	jqvb
𨖏	jqya
鴡	juba
鶪	jubh
且	jubi
𱉐	jubo
𱉘	jubq
𥉁	jubt
䝻	juby
眗	jubz
𧹕	jura
欅	jude
𰘈	judf
梮	judg
颶	juhg
鼰	juhi
𧸧	juhp
𥬙	juhw
𪀏	juhy
䃊	juma
鮈	junc
𧣻	junf
𩧺	jung
𩷐	junh
𱈀	junj
𲌉	junk
𦱅	juta
𧄛	jutc
𩋜	jutg
竘	juyb
𥞵	jxha
𤟚	jxka
䂟	jxkg
𤠙	jxkj
𤗜	jxla
耞	jxqa
𨔣	jxya
𰴙	jysa
𬨇	kdka
犐	keha
𥯚	kehg
轁	kjja
𡼿	kuua
𧂠	kvta
𧄑	kvtd
櫴	ldda
顂	lddb
鑠	lica
檪	lida
櫟	lidf
栃	lidj
栛	lidl
𠢠	lidq
𰷴	liga
棃	liha
皪	lihj
秝	lihl
𥠲	lihw
𥲧	lihx
𥶗	lihz
𩘟	lidr
𰤕	lidt
䴻	liea
𢩑	liec
𢻠	lief
𥣥	liej
𥷗	liel
𪐅	lieo
𥨻	lija
𠠵	lika
𡯄	likc
𤜜	likf
蠇	lila
𤗫	lilc
𧑇	lilf
厯	limo
蟸	limq
𧋠	limx
𧒈	limy
𧓽	limz
𩴣	liii
𭀖	liij
歷	liaa
靂	liac
㱹	liad
歴	liae
瓑	liaf
礰	liah
靋	liai
𣦯	liaj
𫛽	liak
𢏃	lina
𨣸	ljma
𤿅	lkha
𥤞	lkhb
𦫊	lkhf
𬕬	lkhg
𰵚	lkia
𫠂	lkla
詅	lkya
鹷	lkyb
齢	lkyd
𥈘	llbc
膁	lmba
櫣	lmdb
𪍦	lmdf
䆂	lmha
稴	lmhb
𪐋	lmhd
𪖳	lmhf
𨏩	lmya
𩨐	lpna
哷	lpra
𤜖	lwha
𡼊	lwua
𱋡	lzqa
嶁	lzua
𪩇	lzub
𣱉	mbmc
𦀸	mcva
𫄜	mcvb
氋	mgtg
𦫰	mgth
𦱋	mgtj
𦴔	mgtk
𥉿	mibe
𧷦	mibg
𪓬	mihd
𫌪	mihg
𱌅	mihh
𬘮	miva
𢃮	mmla
𦟟	mobb
𱇚	mona
𰈶	mora
𦃤	muna
𣟸	mwda
𩎟	mwdb
篃	mwha
𤚤	mwhb
𨉭	mwhe
𩲈	mwhg
禖	mwia
祙	mwib
穈	mwif
𪎦	mwih
祙	mwma
𩈐	mwmb
䜸	mwmh
𠪃	mwmi
𩩀	ncba
𫍢	ncia
𥧤	nkja
噛	npra
嚙	nprb
踂	nprc
𥖶	pbma
椑	pida
𩔙	piha
𡦟	piya
𩫫	piyb
䓑	pkta
蓱	pktb
𪖈	puhf
㟚	qida
𧼘	qiga
簯	qihg
簱	qihm
籏	qihq
魌	qihv
鶀	qihy
𢩡	qice
𦧉	qied
徛	qira
諬	qirb
𥷇	qird
𩳣	qirg
䅤	qixa
𬸾	qiij
啔	qiio
𡹘	qiiq
𥤥	qijd
𡫁	qijg
𣯆	qijh
𧡺	qijj
蚚	qilh
𧌞	qilj
𢁒	qilm
磧	qimd
𧯯	qimh
𱍐	qims
綮	qimt
炁	qimy
磩	qifd
礘	qife
𤪌	qifj
鯕	qinb
𡖾	qind
𬸒	qipb
𬢐	qiqb
𠔶	qitg
𦸆	qitq
芞	qits
𦭲	qitw
𦫡	qity
𰰴	qiuc
斉	qiyg
𩹵	qiyh
盀	qiym
𩇟	qkid
𩷏	qkna
𧱡	qlmb
𡸤	qlub
𡺃	qluc
繈	qlva
繦	qlvb
𫄶	qlvc
𰗬	qmde
𧣑	qmna
挳	qmqa
𰔲	qmqc
撁	qmqe
攑	qmqg
𫽥	qmqh
𢧥	qmta
茾	qmtg
𱁶	qmth
𦴑	qmtl
𨐋	qmya
礄	qnma
䩌	qnmc
䲾	qnme
𥭑	qqha
𩗕	qqhb
𢈝	qqia
齤	qrfb
𥹳	qrfe
𱌲	qrfi
𤬠	qrha
𥤊	qrhb
孉	qrva
絟	qrvb
𬘥	qrvc
𦛱	qubb
𩪍	qubc
𪌬	quda
𧌑	qulf
𡱅	qusa
迲	quya
覰	quyf
覻	quyg
詘	quyj
誳	quyk
𰴜	quyn
𰴞	quyv
襓	rcla
𫋹	rclb
𬣯	rfia
姙	rfvb
絍	rfvc
𫟃	rfvd
䢇	rsja
軵	rsjc
𡫦	rsjd
鴽	ruva
𥙦	ruve
𩶯	ruvg
𧊟	ruvj
𫂿	saka
牭	siha
𥠱	sihb
𪊍	siia
𧝤	sila
𢕕	sjha
𣯶	sjhb
𧗋	sjhc
𬚄	sulb
𰢄	sumc
𫗧	suna
𱇿	sunb
𡻕	svua
𰵜	tcia
𥌩	teba
𦳝	thta
𰰢	thtb
𥳳	tihc
𥶛	tihd
䎮	tiqa
𩤽	tisa
𧨱	tiya
𱊕	tiyd
𦙇	tjba
㲭	tjfa
𰰆	tjha
嘾	tjrb
藫	tjtb
緂	tjva
綎	tkva
𧓴	tkla
𧹖	tmba
𧰊	tmga
䄽	tmha
畠	tmhc
𦧖	tmhd
璳	tmmd
碵	tmmg
磌	tmmn
𤫞	tmmo
𨡏	tmmq
𤤦	tmms
𦧖	tmmx
𪌂	toja
捝	toqa
𩃘	trma
𧇌	tsya
𬓼	tvha
𪎴	tyta
𪎶	tytb
𧲌	uama
𤳈	uhwa
𤉏	uibb
𧵋	uibg
𥅞	uibl
𧻸	uiga
䈕	uiha
釈	uihf
鼫	uihw
𨽄	uihy
𡠋	uihz
𢼊	uijf
𥥥	uijh
𰳼	uilc
𢁓	uimd
𫀌	uimg
𥑏	uiml
𥛨	uimq
𡅵	uira
𢨝	uitc
𦳊	uite
繹	uiva
戠	uiyc
辻	uiyf
𪊢	uiyg
𪗧	uiyq
齛	uiyr
𨒍	uiyw
脠	ujba
𱖒	ujga
𨝩	ujja
𫁷	ulha
𰰋	ulhb
䴰	uuda
𡦛	uuha
𩳅	uuhb
𢧇	uuja
䘤	uulf
𰡽	uumb
𨅒	uurb
𦈌	uuvb
蒁	uuya
蛻	uvla
裞	uvlb
𨓚	uvye
粍	vefa
䝩	vfba
䲴	vffb
𬘝	vfva
𰬛	vfvb
𪐲	vfwa
𦚦	vgbb
𢹑	vgqa
𫖖	vgqb
䝰	vibl
𧠴	vibq
𦜋	vibs
樴	vidh
梔	vidj
𥏷	viga
䲀	vigd
墌	vigh
縶	vigt
騺	vigx
驇	vigy
𪁓	vigz
䳅	vihd
筫	viht
貭	vihx
𡑘	vihy
𦤻	viaa
䉅	viia
秇	viib
秪	viid
秲	viij
𥝮	viin
祬	viiq
𢇨	viir
𢎈	viit
螲	vilf
砥	vimh
厎	vimj
砋	vimn
禃	vimq
𥘡	vims
𧱒	vimt
𱃸	vinb
𡖻	vinc
𱀑	vini
𪉆	vipe
𱅊	viqd
䟡	vira
𨃯	vird
𦰘	vitf
𮉢	vivn
戠	viyw
旘	viyx
𨑨	viyy
𤿙	vied
㮵	vjda
𫘰	vjna
𧒝	vjsa
𧔡	vjsb
𧖉	vjsc
𩰃	vjse
嶘	vjub
𪘪	vjya
叀	vrja
𡤛	vrva
𦁆	vrvb
𰋹	vrvd
𫁟	vrya
鼨	vsha
𢁷	vsla
中职	vsva
妐	vsvb
櫡	vudd
櫧	vude
𥞏	vuhb
𬹣	vuhc
𡎺	vuie
𬣣	vuif
㝉	vujc
𩊣	vute
芧	vutf
茿	vutg
𰬏	vuvc
𤳯	vuve
謅	vzya
𨟸	wfma
琝	wfmb
蚉	wfyc
螡	wfyd
梚	wjda
輓	wjja
𥤸	wjjc
𨌔	wjjd
𰺇	wjka
𤗍	wjla
𧚇	wjlb
捥	wjqa
𧿙	wjra
綰	wjva
𣥃	wjya
𢄓	wula
霚	wume
鹀	wumi
碔	wumo
𱳳	wumq
忢	wumt
𧎻	wuna
𩝕	wune
齬	wuyb
覹	wwbd
𫌭	wwbe
𧲝	wwhg
𠙕	wwhh
𬣀	wwhj
覣	wwhm
𧢒	wwht
𩗘	wwhw
𩗜	wwhx
𨾂	wwla
𧟼	wwma
䃬	wwmc
磈	wwme
𥒮	wwml
𨠥	wwmr
𩁌	wwna
𡷕	wwub
𧢧	wwuc
䋿	wwvj
媙	wwvk
縅	wwvm
𦈓	wwvn
𥅵	wwyd
瞦	xibe
赥	xigg
𣢎	xihh
𣣉	xihm
𣯪	xihn
𦤈	xiht
𤬕	xihy
𠘕	xiib
𩿛	xiic
𧋐	xilc
𲆦	ximm
覡	ximo
𱅩	xine
隵	xing
𧤤	xinh
𧥅	xinm
𠶨	xird
𡁱	xire
𰬣	xivd
戱	xiye
𢧽	xiyf
䜁	xiyg
卥	xiyw
誒	xikg
𥪦	xikh
𬟪	xiud
𣨾	xkmb
𩈡	xkme
鄕	xlvc
𨙵	xlvd
𣞘	xmda
𩏩	xmdc
𬃫	xmdg
𰉚	xmga
𧈁	xmha
秈	xmhg
箲	xmhj
𢕖	xmhp
𣭡	xmht
𥬍	xmhw
𧠒	xmhy
𰣯	xmke
蚿	xmla
褼	xmlb
𠚆	xmld
𫷉	xmlg
𥙆	xmma
𥜲	xmmd
𩈖	xmmg
珗	xmmh
𥑻	xmmj
𧱀	xmmp
𱈜	xmne
𨺘	xmnh
𢫿	xmqa
𢮂	xmqc
蹮	xmra
躚	xmrb
𠯟	xmrd
𡿤	xmta
妶	xmva
娹	xmvk
𰬈	xmvn
娊	xmvp
𨘞	xmyb
骹	xnba
梟	xnhg
𨊅	xnhh
𤡔	xnka
𤣌	xnkc
𧱐	xnmg
䕧	xntb
訤	xnya
𤟞	xnyf
𪛀	xnyg
𦪬	xpha
𨤴	xphg
𠨆	xpyg
𪙥	xpyk
𫧯	xpyn
𧖁	xpyo
𩫲	xpys
𧙏	xqya
𧤎	xrna
𩑹	xryb
誸	xryd
訩	xsya
𥄵	xube
魖	xuha
𥳗	xuhe
𦪡	xuhf
𩒧	xuhg
𩓣	xuhi
嬃	xuhp
𱅍	xuna
𪙫	xuya
𢻗	xxha
𲂆	xxia
𧾠	xyga
𧾩	xygb
蟳	xylb
𫊻	xylc
𣌨	xyld
𩠇	xyna
𩷰	xynb
𩾄	xynd
𱈓	xyng
𩿔	yame
𧧝	yaya
𬹺	yaye
憗	ybda
檼	ybdb
𬺒	ybdd
𬤇	ybie
冘	ybla
碒	ybmh
𩖄	ybml
隂	ybnb
𦈑	ybva
紖	ybvm
纼	ybvn
𨓮	ybyb
𠕻	ycba
𥃺	ycbe
穾	ycja
窔	ycjc
𥤹	ycjd
䂚	ycma
殀	ycmb
𣨘	ycmd
䔄	ycta
𦾾	yctb
𩋃	yctc
嶤	ycua
𡺯	ycuc
𰎔	ycud
嬈	ycva
𡝛	ycvg
𦆸	ycvj
𬘱	ycvl
𨘔	ycyd
𬑓	yebb
鐷	yeca
𰚱	yeta
胦	yhba
𧲱	yhbb
𧵌	yhbc
𥠜	yhha
𥳜	yhhb
𪕫	yhhc
蝆	yhla
𡹕	yhua
肔	yibg
胣	yiby
貤	yibz
𥃸	yidq
𥅓	yidw
𬥵	yidx
𰷠	yidz
𧳁	yinc
𥄻	yipa
𩪣	yipb
𨦯	yica
𭩚	yika
𣡊	yiii
檹	yira
瀷	yieg
𡍡	yigb
顊	yiha
𥸊	yihw
𩴜	yihx
𪐔	yicb
𩡣	yieh
𩳇	yiei
箷	yiaa
𢕷	yifb
𪁛	yifd
𪈨	yifi
𢨮	yija
𩴮	yijg
笖	yiom
籎	yioq
𣢷	yios
𬱪	yiow
𥰧	yirb
鶃	yiue
𥱃	yium
𤴧	yikb
𰹵	yiki
袘	yilb
𤖪	yils
蛜	yilx
褹	yikl
𧉅	yikm
𢂒	yinf
𰳵	yinp
䗷	yipc
䘝	yipl
𧊣	yipo
𨠑	yimx
𩈭	yimy
𠪗	yimz
𣢭	yiox
𨠶	yiup
𨣬	yius
𩂒	yiut
弬	yins
𱇬	yinx
𱉌	yipw
𢱁	yiqa
毉	yisa
駅	yisb
𣤪	yisl
𧜤	yisq
萓	yita
蘙	yitg
䩟	yitq
羛	yitw
羠	yitx
苅	yity
羨	yioy
嶬	yiuv
𡾾	yiuw
𧔮	yiux
臆想	yixa
讉	yiyq
頉	yiyx
顡	yich
𩔦	yick
𩕲	yicm
𥫃	yiiw
𪙴	yiix
詒	yirg
㫊	yirh
旑	yirl
齮	yirm
𠶷	yirq
𥃿	yjbb
䑍	yjbc
䞁	yjbe
𩩶	yjbh
𩪴	yjbn
𬥺	yjbp
𨪶	yjca
𪂈	yjfb
𥂁	yjga
篶	yjhb
𥷀	yjhh
𥣘	yjhl
𥴿	yjhp
𩗷	yjhw
𩳢	yjua
鼴	yjva
𢔂	yjvb
𩗷	yjvh
𩳢	yjvl
𬤠	yjib
珚	yjms
礹	yjmx
釅	yjmy
𥜒	yjkc
𫑷	yjab
醶	yjod
𰗜	yjdb
𰑕	yjpa
䄋	yjub
硽	yjuc
𡙶	yjue
𩈯	yjuj
𨁍	yjra
𫪂	yjrd
巌	yjun
巖	yjup
巗	yjuq
巚	yjus
𰎹	yjuw
𢇈	yjvn
𦁏	yjvp
𦁙	yjux
姲	yjac
娫	yjad
𦁏	yjae
𫄧	yjag
𮱒	yjaj
𪑈	yjwa
𧩅	yjyl
彥	yjym
諺	yjyp
遃	yjyq
齴	yjyz
𫜮	yjal
龑	yjkd
䖗	yjri
𧇱	yjrl
𨒄	yjrp
䛳	yjuy
䢥	yjao
乵	yjaq
虤	yjas
𣃾	yjaw
𣄑	yjaz
𣥡	yjbs
𧥜	yjbt
𧬌	yjbw
𣄑	yjby
𬸕	ykba
覮	ykfd
𦩩	ykha
𤣎	ykka
𰡢	ykkb
碤	ykma
䚆	ykta
𬢑	yktd
𰥞	ykth
𲁖	ykto
𪕀	yrha
豲	yrmb
𪄁	yrmd
夗	yrna
魭	yrne
𫗟	yrng
𱇐	yrnh
䩩	yrta
𩉯	yrtb
𥿎	yrva
𧖇	ysib
𦣜	ytba
𩎙	ytdc
籰	ytha
𥸘	ythb
𪘳	ytyc
腧	yuba
𦋢	yubl
欝	yuda
艅	yuhs
鵌	yuhw
𣝑	yude
𣟰	yudf
鸒	yufc
𩤺	yufd
𩦡	yuff
歟	yuoa
𥯮	yuoh
𦡭	yuoq
䬔	yuva
毺	yuve
艈	yuvg
𢔢	yuvp
𤚎	yuvw
𦩞	yuaa
𬛼	yuqa
𰔶	yuqe
𪋉	yuia
鴪	yuja
𡨿	yujc
𤹪	yuka
衧	yula
牏	yulg
𰿵	yulh
䨞	yuma
霱	yume
𠀛	yump
𪂕	yumq
㻀	yumu
䄏	yuke
礇	yukf
𬪧	yukg
䃋	yuna
䜽	yung
𧱬	yunh
𦎘	yuta
𦭳	yute
𦱂	yutj
𩋉	yutp
𬝁	yutw
緰	yunl
歶	yuya
逳	yuyh
齵	yuyz
𩩘	yubp
諭	yunq
迃	yusa
袬	yuac
諭	yuad
鄆	yyba
賱	yybc
𪉂	yyma
𪏚	yyta
繧	yyva
𬺊	yyya
脜	yzba
𣓐	yzda
𩘓	yzha
𩴙	yzhb
𦥣	yzhg
秞	yzhj
𥴕	yzhn
𦩲	yzhq
蜏	yzla
𨡴	yzma
𧆕	yzta
𧆘	yztc
䚃	yzye
䛻	yzyg
𧡹	yzym
𨑫	yzyp
𨘵	yzyq
歵	zeyd
𨖊	zeyf
芓	zita
茡	zitb
荢	zite
𦍺	zitg
呰	ziyw
諮	ziyy
啙	zira
𱌘	zith
𪎲	zota
𦈛	zovb
稯	zsha
艐	zshb
𤡆	zska
鬉	zssa
𣀒	zssb
𦖸	zssc
𩦲	zssg
酔	zvma
敧	jiks
㽺	jikw
𤠎	jiky
𬆦	jieb
𣖿	vidn
崻	viua
𠚅	viub
軾	uijs
𱛬	uiub
耭	jiqh
徝	vivq
犆	vivr
𥮖	vivt
蓭	antb
𦺽	antc
𡏼	aogg
𱖎	aogh
擙	aoqg
𢳆	aoqh
𢧴	aogl
𩘮	aogm
靉	aimc
𬤡	aoia
𪏺	bihr
𫠈	bihz
𦡕	bcba
𧵢	bcbb
𩙦	bohx
瓝	bohy
簙	bohz
𤚽	boia
𥭖	boib
𥴮	boic
𰹻	baka
𣁢	bifd
𦱔	bitb
𩉫	bitf
皀	bipa
箆	bipc
𤽊	bipf
箄	bija
魓	bijd
𣭤	bije
𣮐	bijf
𣯴	bijg
𥴬	bijh
𪐄	bijp
萆	bitm
蓽	bitn
鞸	bito
𠦈	bitq
𦸣	bitr
𱁴	bits
𥸥	bosb
𩣡	bosc
𩽁	bnna
𬴍	bnnb
𩊤	bata
𩊤	batc
馛	baho
鼥	bahq
𩠀	banc
𪏗	bmtc
餺	boob
𩟕	booc
𬮁	boog
茊	cita
𦑺	citd
𣩈	comb
𩄝	comc
𮴨	csma
𠩷	dmma
𠫉	dmmb
𣪀	dmmd
𩄠	dmme
禫	djmb
𨡙	djmc
𨢿	djme
碭	dhma
𤺺	djka
豴	dimf
𥕐	dimg
𥖾	dimn
肑	diba
肑	dibc
䩘	ditr
䩚	dits
茋	ditt
菧	ditx
靮	dity
靆	ddmd
𣄰	eema
姶	eevb
𧿕	eera
𥢌	fjha
𦪖	fjhb
𪖇	fjhd
羳	fjta
𩇽	fwmb
𧀮	futv
襎	fjla
𡞪	fuvy
𦂊	fuea
𫄭	fueb
鞴	futx
𦎎	futy
𦸱	fubg
𧀴	fubj
衭	fulx
襆	fuly
襥	fulz
𮔅	fuoa
𠓗	funa
𤙤	fudf
𥰛	fudg
𩳎	fudh
𥠶	fwha
𪁹	fwhd
𦳓	fung
𦽏	funh
𩉽	funj
𨻃	fwna
𣘧	fudl
玜	gsma
𨣂	gsmd
𧎺	gela
𬮤	gelb
狜	guka
𠷞	guhd
𩲱	guhh
㨌	gzga
鷇	gzgb
𣫌	gzgf
𦎯	gzgg
韟	gcdd
𩏤	gcdf
呄	gena
觡	genc
鮯	gend
𩹿	gene
𫚗	genf
笴	gchh
𥢑	gchi
𱦈	gvea
涆	hjea
𧳐	hvbf
啝	hera
𠳇	herg
𠶾	herh
𪡛	herk
𦳬	heta
𦺞	hete
𦽅	hetf
艎	hlhi
𤚝	hlhk
𨉤	hlhn
𦩕	huhw
𩃾	hvmd
𫛷	hujb
𤹣	huka
岾	hjua
綋	hsvb
𦁷	hsvd
𫟄	hsve
𰬋	hsvf
𦨾	hgha
𤽯	izha
𩗡	izhb
𤾦	izhc
𧶔	igbe
𧹓	igbi
𱈘	ihnb
𠝨	iihk
𩳲	iihl
𠛔	iila
倁	iioa
𠋷	ijoa
𩝚	ijob
𠧖	iuyf
𦗻	jusa
𩭊	jusc
䭈	jmob
𰾛	jpob
刟	jusi
巪	jusk
𩫴	jusp
𩬜	jusq
𩟗	jmec
𫗚	jmee
𥅟	jnba
掶	jpqh
𢪍	jpqn
𢫐	jpqt
𧗸	jmhm
𥒡	jias
𩐆	jiav
𡬄	jies
𣪠	jiet
𨍺	jiev
𦂑	jivb
餃	jnoa
𬭻	jnoc
𦎱	jxta
𩊏	jxtb
𬘧	jivq
𰬀	jiaw
嬓	jnvp
絞	jnvq
𰾹	jroa
㒞	jyob
雋	jyoc
啹	jurg
𩴒	jlna
𬶱	jknh
𰝗	jmeg
𡁪	jiax
𧾾	jiay
𰇘	jiaz
𠋻	jiot
䪫	jkyg
鯽	jicb
𨛉	jicf
𩼚	jicl
鄿	jicm
𫟕	jicn
𤮌	jpmb
𨠨	jicp
𫞦	jics
幯	jplc
蝍	jplh
衸	jplj
𮔂	jpln
𦺘	jmrb
𩍎	jmmv
𦿓	jiew
𡗦	jpka
𡗲	jpkb
𥯦	jmhw
𠮯	jisj
𧧃	jisn
蓳	jbtb
𦵾	jict
𤃭	jnea
䢋	jiyy
𱌗	jicv
𨚡	jbna
𪧘	juja
𢎹	jtna
𣬎	jtnc
𫘝	jtnd
䵕	juri
艍	jurk
𢩁	jurl
𥷚	jurp
焏	jifq
鰶	jifr
𪂺	jifs
碦	kema
𣧤	kemb
𥔽	kemd
虁	kvth
𩠮	kvti
鴷	lpma
𤐱	lpmb
𩢾	lpmc
𩼭	lpme
勵	lisa
珕	lisd
𰦦	lisf
𤃨	ljea
𬉠	ljeb
𢮃	liqa
𩟃	lkoa
𩟃	lkob
黐	libf
𣯤	libh
𪖂	libj
靇	lsmb
𰦭	lsmc
𱈊	lqna
厤	lidv
瑮	lidx
瓅	lidy
𠩵	lidz
𥓃	lial
𥼅	liao
𩄞	liap
𩅩	liaq
𬍛	liar
𰾮	lmoa
豊	lita
𧆺	lkod
𠶱	lomb
𣧳	lomf
𩂣	lomh
雴	litc
𥁟	litj
酈	lilh
𨜼	lili
𨞺	lilq
𨟑	lilr
𫟫	lilt
𮷨	lilw
𢾬	luya
𥀵	luyh
𧨹	luyj
𣿊	lmea
霗	lkmd
𠾥	lkmk
𧱢	lkmt
𨠎	lkmx
𩆼	lkmy
𤡿	likh
𩗭	likj
鯬	life
鵹	liff
鷑	lifi
𥷅	lifj
𪁐	lifl
𦺫	lhta
𥶇	luhb
𱸧	luhd
𠼝	lira
𨃙	lirc
𫄥	liva
𥎓	linc
𩶘	line
躴	lhha
𩳤	lhhb
𱏱	lcoa
𬰥	llta
飅	lqha
𢔲	lqhb
𥠷	lqhc
𥰣	lqhg
𥶅	lqhi
贚	lsba
𪚘	lsbb
𫎦	lsbd
朧	lsbe
酾	libl
㡂	libo
䄜	libq
礪	libr
禲	libt
𦠓	libu
𨢌	libv
𩱇	libw
襽	ljla
𰏟	ljlb
𩴤	lnha
𬲅	lnhb
䛚	ltqa
𦽎	lutb
祿	luma
靁	lwma
𩨉	lana
𧢝	liua
𰴗	liuc
冡	mgba
𥉕	mgbb
𬪍	mcha
𪋗	miic
𦥦	moha
𬇰	mfea
𤥰	mcma
𤣻	momb
𧰱	momf
𩃁	momg
𥇆	mibh
𦟂	mibj
𢄐	mgla
𧞑	mglb
𤯻	mgha
𤾬	mghc
𥣛	mghd
爢	miie
瑉	mbmd
𧠊	mcba
𫤸	mcbb
迡	niya
𩩢	nibb
糱	npua
𡿗	npub
𩅽	nsma
𦊁	piwa
𣴪	pdea
𬨔	pika
䅭	phha
篣	phhb
𩄦	pgma
𧾑	piga
肶	piba
𨲐	pisb
𬸯	pisd
𪗅	qiyp
𦄊	qiis
䄎	qirh
唘	qiri
啓	qirk
𤘌	qirm
𥔩	qirn
𢩡	qiit
𰵲	qiiw
𡰝	qrka
蘄	qilw
鄿	qily
𦸗	qifm
𪂛	qifn
𪅾	qifo
𠠃	qmoa
𥍯	qbnb
齎	qiyq
𨒅	qiyw
𩒛	qiyy
茙	rsta
佀	sioa
飴	siob
𬭀	sioc
𠋢	szoa
𠌞	szob
𠌟	szoc
𡊨	tjga
𪂌	taeb
杔	todc
𡩆	tode
𩎼	todf
𪌂	todj
禫	tjmd
𦧴	tjme
鯷	tina
𠈁	tooa
犝	tsha
馟	tuha
鵌	tuhb
𤙛	tuhe
鮀	tona
鿳	tonc
鿸	tone
𧣖	tonf
𱇏	tong
鼪	ugha
𬸆	ughd
𮸌	uioc
鯴	uina
鰣	uinc
塒	uigb
䱇	ujna
䱉	ujnb
鯅	ujnc
𱇞	ujnd
㡎	ujla
𰄁	ufib
𩙾	viod
簗	vuhk
𦧙	vuhp
𪏿	vuhr
𦟔	vibt
䬹	vioh
𠋤	viol
𥎹	vioq
磌	vfma
禎	vfmk
柤	vadb
査	vadd
樝	vadg
𣛽	vadh
𫛠	vadk
軽	vijd
𡌴	vijl
𠮡	virh
𨁷	virj
酈	vimw
𣨋	vimx
𫟞	viiw
𩴀	vuht
𥠽	vikd
邅	vjyd
𱌵	vjyg
𬘨	vivw
𦉂	vsoa
𢨱	vshb
淽	vieh
𦳏	vatb
䇛	vimy
凪	viac
徝	viad
犆	viaf
秪	viah
𥮖	viaj
𱇹	viam
𱼷	viao
𨎉	vijq
𡎺	vume
𬭡	vcoa
𱂷	vjyj
𦩬	wwhz
𬬬	wwoa
𩲂	wwia
䍴	wwta
葨	wwtj
螱	wwsa
䯈	wjbd
䯛	wjbe
睌	wjbg
睕	wjbh
脕	wjbl
貦	wjbm
𧲦	wjbn
𰷡	wjbo
𤀷	wwea
𤁿	wwed
𩢌	wfye
𩄯	wumv
琓	wjma
𢀗	wjmd
𩹥	wwne
𩹷	wwnh
莬	wjta
萖	wjtc
薍	wjtd
𦽞	wjtf
𩊁	wjtg
𥭠	wuha
𥲐	wuhe
𩳌	wuhp
𩨅	wwnl
𩹂	wwnp
𩼂	wwnq
𱈃	wwnr
綩	wjvc
嵔	wwuh
碬	xxmb
𢻗	xxmj
𪄛	xihz
𢯉	xpqa
𠀦	xkmf
𡼚	xnra
臽	xmnk
𱇻	xmnr
笅	xnhj
筊	xnhp
𣉖	xrab
𧹽	xigh
粯	xmfb
𬖑	xmfd
𦑍	xuia
𤺊	xikj
𦭶	xmtd
𦸊	xmtg
䙝	xpyw
𡣹	xpyx
𲀯	xpyy
槢	xidc
巺	xyrb
𣢂	xisg
屳	xmod
仚	xmog
佡	xmoj
俔	xmok
𮸠	xmon
𰽢	xmop
𬭳	xioa
稧	xikq
𥰥	xiks
朂	xuaa
澙	xieb
𩾼	xiec
𩽨	xino
𫘱	xint
䏹	xmbg
鷴	xmae
鷼	xmag
𫰰	xmvq
𢴲	xpqd
𣨤	xuma
𥕰	xume
𧟬	xumf
繻	xuve
𦅏	xuvg
𱄆	xinw
纕	xlvk
齘	xpla
隃	yunt
魣	yunx
𢎻	yunz
𩨈	yuae
袲	yiva
𤣨	yivn
𧱏	yioz
𩟳	yuot
籅	yuca
籲	yucg
軉	yucj
輿	yucn
𥷔	yuco
𥷞	yucs
𥸤	yuct
𦦫	yucu
𦦲	yucv
䶧	ycyh
謡	ycyl
𥪯	ycyo
𱌰	ycyp
𣄝	yjoe
𤬝	yjoj
頤	yisx
𠥦	yisz
蒕	yytb
蕰	yytd
薀	yyte
藴	yytf
㼶	yuox
𠊏	yuoy
𩛪	yuoz
𨂒	yera
𫩫	yerg
鶧	yktp
𩋹	yktq
䱷	yukh
䲣	yukj
𠄮	yamj
𩃐	yamq
𱉨	yamr
𧱬	yuag
飴	yirx
𥏜	yiry
㷳	yjfi
醼	yjfl
鳫	yjfo
鴈	yjfp
黶	yjfq
𣩙	yjfs
暥	yjbz
閹	yjcb
𨴣	yjce
𨶁	yjcg
鱊	yubq
𩱌	yubt
𩱱	yubu
𫚪	yuby
𱅫	yubz
𱈂	yuah
𢬍	yeqa
齸	yiab
𧬇	yiac
𱌽	yiag
𢒰	yukl
𥘒	yiiy
𥙇	yiiz
𰑸	yipx
𰶊	yipy
𦦿	ykbd
䒡	ybta
䓄	ybtb
訑	yiai
𧦧	yiak
𠏩	yial
𠐀	yiam
𩛮	yiaq
䞅	yirz
貽	yiar
𦟧	yias
𩪟	yiav
侇	yiny
𧆦	yinz
渷	yjea
灔	yjeb
灧	yjec
𡁊	ykra
㜒	yivw
嬄	yivx
彜	yivy
紲	yiaw
縊	yiax
𠰄	yiay
𠼪	yiaz
俁	yukq
飫	yuks
𢾄	yukt
𰂏	yuku
㱲	yicq
䄁	yicw
玴	yicx
𩍖	yipz
斔	yuai
諛	yual
𣢦	yuap
𣣎	yuaq
𠒜	yrmh
瓔	ykmb
𥚿	ykmc
瘱	yikq
𪽷	yikv
㺮	yusg
亐	yush
𩂧	yusp
𨰸	yucw
鷂	ycbh
𤬖	ycbl
嬮	yjcj
硽	yjck
饜	yjcl
𩃀	yjcn
𩈯	yjco
𰋽	yjcp
𱃲	yukw
𱇕	yukx
祤	yuar
𱉍	yuas
厊	yams
𤘆	yamt
𧠽	ycje
𨍳	ycjh
袣	yicz
䴬	yiem
耴	yies
𧢂	yiew
嬑	yiex
絏	yiey
繶	yiez
𥾐	yifl
扅	yifo
虒	yifs
鳦	yifv
𠛃	yifx
𢓡	yify
𢖅	yifz
𦨇	yigx
𪀓	yigy
𠘥	yjic
𥜒	yjid
𤅸	yjee
裺	yjla
褗	yjlb
𤗎	yjle
鼝	yrea
𨻣	yrnj
鱅	ysna
𧼫	yuga
𦴊	yhta
𩰽	zsmb
礠	cima
𠩆	cimb
𨠐	cime
𩉋	cimh
軥	gzja
𩈣	hjma
𡖳	iikc
𤟆	iikd
𫖅	lsta
𤢹	lwka
𫐙	lwkb
𨡩	pomc
𦳇	tmta
𪎾	tmtc
𩷌	uunb
𬌮	ycka
𰟘	yjfw
𨼬	xpna
𨲋	bisk
𩭧	bisp
𣀣	fuig
韉	jmfb
鶼	jmfc
蠒	jmmx
𡬵	jmmy
𠅌	yikw
𣦌	yikx
厴	yjlj
𤜹	yuie
𥛩	yuij
㹫	yiky
䖊	yigz
𠜁	yijh
𤝻	yijj
齞	yjcq
𪙊	yjct
𱌫	yjcu
旣	jiup
穊	jiuq
𣄯	jiur
𩠨	jius
𪘥	jiut
𱌸	jiuw
粉白色的	ffba
遀	svya
𨺸	mcnb
𥗺	ljmb
𦧼	ljmc
𬎑	ljme
蓺	yijs
萟	yijt
芸	yijw
臸	viaq
𡍶	viar
𥒓	viat
𥔊	viau
鷔	aoql
𩮯	aosa
𫄰	bhva
䏢	bibt
𬥶	bibx
𪍪	bida
𮲰	bidb
𰞲	bife
禆	biia
𥛘	biic
𪋜	biid
𰃻	biif
𮤲	bilx
螕	bily
𢅩	bilz
𢘍	bipi
𫚑	bind
𱅈	binf
𱂅	biqa
𰋾	biva
𰬎	bivb
𰬤	bivk
𰽼	bkoa
𪖯	bmha
𤻶	bmka
徱	bnha
爂	bnhb
穮	bnhd
颷	bnhe
飈	bnhg
𤐫	bnhi
𩙪	bnhl
𩴩	bnhm
溊	boec
秡	bokc
馛	bokf
𥮯	bokg
𦤚	bokh
𨈩	bokj
𩗒	bokk
鱍	bonc
𩧯	bong
𱇣	bonh
𩌏	botf
𩍿	botg
鱉	bpfa
𤉤	bpfb
𩦉	bpfd
𪂟	bpfe
𱍈	bpfh
𤿒	bwde
𥴺	ciha
𩢑	ciya
𥮾	cjhb
䗞	cjmc
䘉	cjmd
蝅	cjme
蠺	cjmg
𤄓	csea
𰛏	cseb
𥡬	csha
𥵫	cshb
蟌	csla
𧝮	cslc
騘	cssa
驄	cssb
𦇎	csva
𰭁	csvb
𣿒	cvea
𥻮	cvfa
𥼺	cvfb
𣯧	cvha
𤛍	cvhb
𨊉	cvhh
𦙯	ddoa
𤔶	dhhe
𥢷	dhhg
𦨢	diha
𦨢	dihf
阺	dina
鯳	dinb
𬲮	dinc
阺	dind
鯳	dine
𰂗	dioa
𱊱	disa
𬂅	djbb
𩅾	djmg
𫡶	djmh
𫫦	djra
𧂄	djtb
𦨍	dkha
靪	dkta
癲	dmka
𤠶	dmkb
𠶰	dnna
𠛫	dona
𥷕	dpha
疉	dpwa
𪍹	dudd
𰤬	dujf
𩈜	dvmb
䳘	eehb
皒	eehd
𢨡	eehg
𧒎	eehh
𪅴	eemb
珴	eemd
琧	eemh
蝁	eemm
𰲸	eemq
𤪄	eemx
𥑺	eemy
𨂁	eerb
𧨟	eeyb
𪘊	eeyd
𠛸	ffla
𦍪	ffta
𦰛	fftb
𦶚	ffte
𩉵	fftf
𰱍	fftg
𩪌	fgba
𣿝	fgea
𩘵	fghd
𩉧	fgta
𩊩	fgtb
綘	fgva
𤖀	fgvb
𮶂	fgvd
𩷸	fhna
麬	fudp
𪂋	fubp
蛗	fuih
𠪻	fuij
𥲛	fuim
𧒂	fuiq
𧒙	fuir
鳬	funp
𤭟	funq
𦨡	funr
𩖼	funs
𥨍	fuja
鬴	fumr
𥒰	fums
𩅿	fumt
𩂔	fumv
𱅎	funt
𰾟	fuog
𠓗	fusb
𩬙	fusf
𦿁	fuwa
𩋨	fuwb
𩍏	fuwc
𦇁	fukf
𫄢	fukg
𧝇	fwll
𥄱	fwlp
𥇖	fwlr
𩇯	fwlt
𮸽	fwnc
𮹂	fwnd
𦈗	fwvb
賅	gdba
𰇀	gdya
𤕒	geca
鴚	geha
𢓜	gehc
𣭝	gehd
𤜊	gehf
𥰮	gehg
𪀁	gehl
合	geoa
𦓱	geqa
𱂆	geqb
𱋓	geqc
鞈	geta
𮀲	ggma
䱴	ggna
𬶊	ggnc
𱇥	ggnd
𱈇	ggne
𱈈	ggnf
縆	ggva
𬘵	ggvb
𰬌	ggvc
𮭰	ghya
𣽰	goea
𨉹	goha
𬱿	gohb
𤬳	gsmg
𨒱	gsya
𥈸	gvdd
𬃀	gvde
觤	gvnb
陒	gvnd
𥍨	gvnj
𧡫	gvnn
𫚜	gvnp
𥈓	gxba
筈	gxha
𠯑	gxhb
𧲿	gzba
𫎧	gzbc
𱸡	hchh
𨂜	hcri
𡫥	heja
𧯉	hejc
𨍇	hejd
鸖	hemd
𪈊	hemh
𫓼	heoa
𧇎	heya
𧇮	heyh
𧨂	heyl
𧬱	heym
𩐥	heyo
𪏓	hghb
𥮕	hhhb
𦨵	hhhc
𧘃	hhhe
𪕇	hhhi
𲀟	hhhj
𩹼	hjja
𠦊	hjmb
𫘛	hjna
𫘣	hjnb
𣢺	hjoa
𰙎	hjob
𱊽	hkyc
爌	hlfa
𦪗	hlhp
𪏒	hlhs
𣄙	hlyd
雘	hobb
𩪭	hobd
鸌	hohb
𣄸	homc
𨥺	hsca
𤂲	hsea
灴	hsfa
焢	hsfb
𥰲	hsha
𩗄	hshb
宖	hsjb
𥥈	hsjd
𨌆	hsje
霐	hsmd
𧋔	hsme
𣎚	hubb
㷤	huga
㺉	hugb
嗀	hugf
𣫈	hugg
𣹬	hugh
𧹲	hugj
𪕱	huhz
𱝴	hubc
𤇠	hufc
𦏗	hufe
乯	huna
衚	hunf
𦩕	hung
𬶞	hunh
𱇓	huni
𧅰	hutg
𰛦	hvee
𬨐	hvka
𧭾	hvyv
𩅴	hymb
𦞈	hzba
𦞕	hzbb
𬥽	hzbc
𫗯	hzna
𱈄	hznb
𬭠	iaoa
蠆	idta
𧔴	idtb
𫎪	ifba
𧡬	ifha
鵣	iida
𪅙	iide
𰒒	iiec
𥱻	iihp
𣙰	iisa
𨘾	iiyp
𪉗	iiyu
𨑠	iiyw
𧭟	iiyx
𥊓	ijba
𦢙	ijbb
𧾡	ijga
𩽝	ijna
𪙞	ijyo
𦿀	iutb
賰	iybb
𦚧	iybc
𦧈	jbhb
䤐	jbmb
𪄵	jift
𨪏	jicw
𣜇	jicz
𨋉	jiey
𣰈	jiio
𤤋	jiiq
𥣩	jiis
𥳏	jiit
𪅹	jiiv
𤛄	jiez
𥠋	jifv
𥡒	jify
𥳏	jifz
𪅹	jigh
𬓠	jigj
𥭌	jipa
𥭜	jipd
𩴃	jipf
㞆	jigm
秶	jigp
𠍃	jiow
𩜆	jiox
𰽕	jioy
嘰	jigq
𠹋	jigv
𦺬	jigy
𢁂	jiuy
𥾊	jiiw
𦇧	jiiy
𪊆	jixa
繦	jlva
𣠷	jmdb
𥴱	jmhz
馢	jmik
𢩀	jmil
𣮏	jmin
劒	jmof
餞	jmog
𢦺	jmop
偂	jmor
餰	jmos
𰱇	jmbd
𰱑	jmlk
𪆿	jmyd
𩴧	jnfb
𪚰	jnfc
𨸋	jnlc
𨱓	jnod
𤘦	jphn
𧜅	jplw
𧣋	jpnb
𩧦	jpnc
𬶇	jpnd
𬶎	jpne
𠡶	jrfe
𠢚	jrfg
𤎱	jrfh
𫞝	jtea
瑴	jtga
𧾵	jtgb
𧣸	jtnf
𧥎	jtnh
𧷾	juaa
𧤑	juac
𥮗	judh
𩧒	jusu
𩿝	jusw
𨝮	jusx
詎	juyf
𦧮	jxhb
軻	keja
𣩄	kemf
𥕤	kemg
𨢸	kemh
𮡈	kemi
豤	kfma
𣍦	klba
𰹶	klka
𲉨	klkb
迋	klya
𨖢	klyb
𦧍	koha
𧚬	ksla
秙	kuha
𥞴	kuhb
𥟾	kuhe
𥯶	kuhf
𬕛	kuhg
顝	kvba
𰾥	kvoa
𬆮	kzga
𥼭	lbfa
𤛮	lcha
𥢒	lchb
𬧤	lchc
𱸇	lchd
𪁔	lcja
𧰎	lcmb
𨣃	lcmc
𫞧	lcme
𮀤	lcmg
𰼋	lcmi
麳	lddd
𰘳	lddg
𫗨	lhnb
𥻿	lifn
𩳓	ligb
𩘡	lias
瓥	liil
𦪶	liin
𦫈	liiq
𪕴	liir
𨊛	liat
𩙖	liau
𩧸	liav
𪖍	liaw
𪗁	liax
𫚞	liay
𬸎	liaz
𱊃	liby
𠛦	linf
𠞙	linh
𤭜	link
𥬭	linl
𢛮	lipa
𢤂	lipf
𱃚	lisl
𨝟	liuf
𣘬	lijc
𨍫	lijw
𠫌	lieq
𣀥	lier
𣀷	lieu
𤩮	liew
𫾲	liex
琍	lino
𠞉	linq
𠠏	linr
𠠝	lins
𣧿	linv
𫥳	linw
𫥵	linx
𢍼	liph
𩆝	lipi
𧯏	lirj
𰴢	liny
𩯺	lisr
𩣫	liss
䔧	litl
蘺	litn
𦎐	lito
𧄚	litr
𠞤	live
𦃇	livf
𨓦	liya
𨤫	liyc
𫁡	liyh
𠓖	ljfe
𰫖	ljfh
𥜓	ljmg
𨣨	ljmh
𫞨	ljmi
𰼏	ljmj
𨅬	ljra
𪢌	ljrb
𪢠	ljrc
𬞕	ljta
𱁽	ljtb
𱁾	ljtc
𫱕	ljva
䠲	lkhj
彾	lkhk
皊	lkhm
秢	lkhp
笭	lkhq
𩖵	lkhs
𩲩	lkht
𪕌	lkhu
䠲	lkhw
彾	lkhx
皊	lkhz
秢	lklb
笭	lklc
𩖵	lkld
𩲩	lklf
𪕌	lklg
𠾥	lkib
𧰻	lkid
𧱢	lkig
𨠎	lkij
𩂙	lkik
𩆼	lkin
𩵀	lkip
𧲙	lkra
𩆮	lkrb
鹷	lkye
齢	lkyf
𮖁	lllc
啢	llra
𥽸	lmfb
𢅖	lmla
𤬓	lmta
𰬾	lmva
𮱇	lmvb
鷯	lnka
𤊽	lnkb
𥛰	lnma
𨣀	lnmb
𩯊	lnsa
𤽥	lohb
𥯛	lohc
𨇽	lora
𧭥	loyb
𩼊	loyc
𥶢	lpha
𱃘	lphb
𩙑	lphc
𠛓	lqhk
𱃙	lqho
䝀	lqma
璢	lqmb
畱	lqmc
磂	lqmd
鬸	lqmf
𠪐	lqmg
𥛅	lqmi
𨢇	lqmj
𩆎	lqmm
𩪾	lrvg
𪚝	lsga
徿	lshe
𦨩	lshf
𦪽	lshg
𩙘	lshh
𪐖	lshi
𪫌	lshj
𬧢	lshk
𰩅	lsja
𪚓	lska
𫜲	lskb
𰽦	lsoa
𱛓	lsua
鵦	luhf
𤽺	luhi
𥣤	luhk
𰩲	luhl
𥀔	luib
𥛞	lumb
𩅄	lumd
𤿴	lunb
𫘧	lunf
𮬠	lunh
𱇶	luni
彔	luva
𤿴	luvf
𧃒	lvta
𩔗	lwfa
𣡺	lwwa
𤳳	lwwb
𡃝	lyra
𧷡	lzba
軁	lzha
𰰑	lzhb
𫷹	lzia
𪍣	lzja
𤠋	lzka
𰏜	lzla
𧰃	lzma
𰶬	lzmb
𱈆	lzna
𰭚	lzta
𱁺	lztc
𱌈	maia
𦫮	mbrb
覒	mchb
𢅉	mche
𣯀	mchg
𥟪	mchh
𨈥	mchi
𬆾	mchk
𲌰	mchp
兞	mcja
氂	mcjc
軞	mcjd
𦢧	mgbd
𰥭	mgbe
𱌆	mgbf
𨢊	mgma
𩄖	mgmb
𱈛	mgna
𪈆	mgtq
𧁊	mgtr
𧂡	mgts
𰱉	mgtv
𱇮	mhna
濗	miee
𥹄	miyb
𨒲	miye
𰯎	mjba
𥌂	mmba
𧸨	mmbf
𡧍	mmja
𥤵	mmjb
𩞁	moic
袹	molb
𩹾	nana
𱇔	nanc
𱇴	nand
𰡻	ncma
𬴨	ncsa
𤙌	nihd
𧖷	nihf
𪏸	nihg
𬶪	ninc
𩋪	nita
𰣩	nkka
𪐇	nmha
齈	nsha
𱌖	nshb
𰧾	nsib
𬴩	nssa
𬭗	nwoa
𧅘	nzta
𱸂	ouha
𧖼	ouhb
𱌹	ouyc
𩰗	pbla
𣕅	pcda
𩎘	pcdb
𩎾	pcdd
颮	pcha
𩗥	pchb
𲋏	pchc
𩐜	pcya
簲	pdha
𥯟	pdhb
𥱼	pdhc
𥴖	pdhd
𣟀	pgda
𨎳	pgja
蘕	pgta
䨦	phma
𤧭	phmb
𩃎	phmc
𪌈	pidb
𦨭	pihb
𪖞	pihd
𪇊	pihg
𪉔	pihh
𣬉	pihk
𤚪	pihq
𥯡	pihr
𨈚	pihs
𱇒	pina
𥀘	pisg
鷿	pisi
𦹽	pitb
簈	pkha
𦥤	pkhb
𪔾	pkhc
𪕒	pkhd
𧏑	pkla
㸤	pmya
篻	pnha
飃	pnhb
魒	pnhc
𨂩	pora
𨅅	pord
𭇜	porf
𤗵	pula
𦡹	qibb
𩨘	qibg
桼	qidb
𣏶	qidg
𣾤	qiej
𦪊	qifq
𨉸	qifr
𩲪	qifs
𡹘	qiuh
𥫟	qium
𢺷	qijk
𤺗	qika
𬨂	qikb
𧕉	qilz
𩥂	qisb
𨙬	qisg
𨦄	qmca
鑓	qmcb
𠔺	qmcc
𢃘	qmha
籖	qmhh
𥷪	qmhj
𣢖	qmhk
𨺫	qmhw
𧢞	qmhx
𠑲	qmod
𠊭	qmoh
𠔺	qmtp
𫭪	qnga
𰷵	qngc
𪺭	qnha
𦆍	qpvb
𰬡	qpvc
龝	qqhc
𬓫	qqhd
𨺧	qqnb
𰬗	qqva
𢔑	qrhc
𪐂	qrhd
㲉	qtgc
𣪹	qtgf
𥀎	qtgg
𩣹	qusb
𡱺	qusc
𦕙	qusl
𦗛	qusn
𰽻	rfoa
𬥻	rrba
𥼬	rsfa
𫞡	rsfb
𣯍	rsha
𣯏	rshc
𥬪	rshd
𨉴	rshf
𮉫	rvva
𬂀	ryba
𩐅	saha
𥰱	scha
𤛷	seha
飔	sihe
𥯨	sihf
𪕳	sihg
𩅰	simb
𪆗	sita
𱎠	sitb
𩙭	soha
𩡾	sosa
𣚜	ssdb
𲆩	ssma
𩞅	svoa
𣮬	szhb
𣯜	szhc
𫠑	szna
𩮃	szsa
𦧱	tahb
𦪙	tahc
𦧞	tahe
𩌐	tatb
𨙎	tayb
𤚟	tcha
𩙧	tchb
𱃗	tdha
𦫀	tgha
𦪀	thha
𩘜	thhb
𪕹	thhc
𧱵	thma
𪖦	tihe
𬶕	tinc
𩤽	tisb
𩮜	tisc
𩨑	tkbb
𡈼	tkha
𥫙	tkhb
𨉬	tkhd
𩆆	tkma
鴕	toha
鼧	tohb
𥞒	tohc
𨈷	tohe
𩃰	tome
𣗸	tonh
𤱡	toni
𫘞	tonl
𬴎	tonm
𧿶	tora
𩧐	tosa
𧧉	toya
𩩅	tsba
𨈹	tshc
𩍅	tsta
頽	tvhd
𥢢	tvhe
𥶐	tvhf
𩘺	tvhg
𩂄	tyma
𣣮	uaha
颵	ucha
𥳓	uchd
𥵦	uchf
𱇯	ucna
𦿃	ucta
𱇙	ufna
𱆌	uhmd
𬀷	uhoa
鶳	uibn
𥫴	uibr
𬕄	uibs
𧠜	uiid
𠩔	uimt
𥜰	uimx
𥐘	uimy
𬬷	uioe
𨹊	ujne
𩟋	ujoa
毺	uuhg
𠘧	uuhh
𠙎	uuhl
𤘷	uuhm
𥳕	uuhp
𧗱	uuhs
𫌋	uulg
焂	uuoa
鵨	uuob
𪅰	uuoc
𫝋	uuoe
𫉄	uutb
𰶄	vaib
𪗵	vayb
𩘀	vcha
𩙩	vchb
𪁧	vfml
𫖬	vfmm
𧸕	vibx
𰊂	viby
𤆒	vifb
𤓕	vifc
𫟬	vilh
𥭡	vipg
氏	viph
𧊙	vils
𥒗	viix
𨟾	vipi
𨻆	vinr
𩻼	vins
𱉛	vios
鼅	viot
𱌄	viox
𡂒	virk
𩯈	visb
𬺁	viav
氊	vjha
𥴐	vjhb
𦧚	vjhd
𦧚	vjmb
𨣁	vjmc
𩨍	vjnc
𩔣	vjyl
𪉜	vjyp
𪗦	vjyq
𬸵	vjyt
𥷘	vohb
𥷮	vohc
𩲃	vohd
𥮥	vohe
𥯩	vohh
𩋁	votb
𨖮	voya
𥛥	vrma
𤚏	vshc
𥷈	vshd
𨉢	vshe
𤺄	vska
𧬤	vsyd
瀦	vuec
𫞛	vuee
𪋰	vuik
𧉞	vulc
𤾄	vumh
𰧘	vuml
祩	vumm
埀	vvha
𧳜	vzba
𧣷	vzna
𮹋	vznc
𩍌	vzta
𬰤	vztc
𥲠	whha
𧫢	whya
𨕿	whyc
𨩵	wjca
𨩻	wjcb
箢	wjha
𢓆	wjhb
𥟶	wjhd
𦣾	wjhe
𧠆	wjhf
𨉝	wjhg
𪂧	wjhh
鯇	wjna
鵐	wumx
鵡	wumy
𥕻	wumz
騖	wunh
鰞	wunl
鶩	wunn
𨼊	wunp
𩻚	wunx
𩝷	wuoa
𥏒	wuob
𧸽	wwbj
𥶽	wwnt
𤜂	wwqa
𥯤	wwqd
𧚷	wwlf
𧛚	wwlh
鰄	wwnw
鳂	wwnx
𧤖	wwny
𫗪	wwnz
𫗭	wwvo
𪂄	wwob
𩋾	wwtm
𰥢	xibh
𣎮	xibl
𧯊	xica
𩎥	xidh
舃	xifc
𪃼	xife
𡘐	xikx
瓗	ximq
襾	xims
𨡂	ximx
𧤟	xinx
𬳋	xiny
𢙅	xioc
𱃟	xisp
𩍆	xitj
𦱓	xitv
𡗞	xive
𡜧	xivn
𤬘	xiol
𧦁	xioq
𧗦	xkhd
𰲶	xklc
𬶢	xkna
𱇡	xknb
𩡠	xlhh
𥿧	xlvm
𧬰	xlvn
𰛵	xmea
鼸	xmca
𣰷	xmmq
𠜎	xmnt
𢖋	xmnw
𥲋	xmny
𢋮	xmia
𲍏	xmnz
𧈁	xmtl
𬜾	xmts
𱅮	xnbc
𤞚	xnkg
𤠖	xnki
𤷤	xnko
𩫳	xnrc
𩱴	xnre
𧝫	xpld
𧟃	xplg
𧏂	xplj
𧏃	xplm
𧐃	xpln
𧑦	xplp
搚	xpqg
𧀢	xpth
𫄬	xpva
𧭸	xpmd
𱂎	xpmh
𪀪	xqoc
𧔤	xrbb
𱅖	xrnd
𩋫	xrta
𦓈	xsja
𣰃	xuhq
𥮪	xuhx
𦠷	xuhy
𫷈	xubh
𪾔	xutb
𰩧	xutg
𬨏	xukf
𩑕	xumg
𩽆	xund
𱅧	xung
魣	xunh
𨹘	xunk
𮬛	xunp
𩒇	xura
𦰲	xuth
𱙧	xuvh
𣚏	xuye
詡	xuyg
譃	xuyk
𪙫	xuyn
𤙇	xxhb
𦦕	xxmk
祫	xxmp
雃	yamw
𭭈	yamx
湚	ybea
𣽮	ybed
𩃬	ybmq
乑	ybob
飮	yboc
𫡑	ybod
𣦫	ybye
𨒦	ybyf
𤬔	ycha
𪖐	ychb
𰠴	ychh
𫍚	ycia
𬺟	ycoa
𫜪	ycyw
𣩫	yeme
瑘	yemg
𢀘	yemi
偞	yeoa
僷	yeob
𰾕	yeoc
𱌀	yhlb
𫚊	yhna
𱁱	yhtb
𦠉	yijy
𰷪	yijz
浂	yiqe
湙	yiqf
𭣧	yiqg
㴁	yiqo
㴒	yiqs
溰	yiqv
秇	yiqw
鸃	yiqx
𩘧	yiqz
𱊈	yiwa
䬁	yiwb
𢓀	yiwi
𥫝	yiwl
𩖹	yiwm
𫍙	yiwq
𫍟	yiwr
𢈶	yiwx
𢦕	yiwy
𤬩	yiwz
𰵖	yixc
𰵥	yixe
𰶁	yixf
𬤞	yixg
𰵔	yixh
𧙡	yixj
𧱊	yixo
𩂹	yixr
𥘒	yixu
𥙇	yixv
𩠂	yixw
𡥁	yixy
𱇧	yixz
𮩞	yiza
𢖴	yizb
𬬩	yizd
𩚂	yizf
恞	yizg
𱉇	yizj
𠿣	yizk
黳	yizn
𤇴	yizp
𩥯	yizq
𩾠	yizr
𠚮	yizt
𡱐	yizv
𧅖	yizw
𦮸	yizx
辷	yizy
𪁡	yjkg
𱅬	yjna
𥍻	yjnb
𨻂	yjnd
𩻖	yjne
𫘫	yjnj
𫚢	yjnk
𦖈	yjsa
𦖧	yjsb
鷰	yjtb
𤯇	yjte
𮹜	yjth
鸚	ykbe
𩻷	ykbg
熒	ykfl
禜	ykfo
鶑	ykfp
𬤚	ykia
偀	ykoa
僌	ykob
矨	ykoc
𮐨	ykts
𰌀	yktw
𩕾	yrwa
𨈋	ytra
𦋢	yuat
𩨙	yuau
𣕃	yudj
𫗇	yuaw
𬲆	yuax
𨞓	yulp
𩡃	yulx
魊	yuaz
𥝍	yucx
𱊭	yucz
毺	yudp
衘	yudt
𢔢	yudx
𢔬	yudz
𢖡	yuei
𤚎	yuej
𦩞	yuep
𧗪	yueq
𱃞	yueu
𧍪	yulz
𧑐	yuew
𩈕	yuez
𥙿	yura
𩺰	yufg
𫓾	yufi
𰾙	yufj
𩝗	yufl
𰾆	yurg
𢡎	yupa
𧃠	yutx
𩋤	yufn
𰬻	yufp
𪑝	yuwa
𪍝	yyda
𤸈	yzkb
𬨎	yzkd
𥙾	yzmc
𦳷	yztf
𦷿	yztg
𣣜	yzvc
繅	zcva
贜	zhba
𰷭	zhbb
矷	zima
秶	zime
𱹼	ziva
𪗉	zidg
𱌙	zila
𣣊	zioa
禶	zjma
𦥬	zohb
葄	zotb
𮳳	zsfa
𭎂	zsga
𮪣	zsna
𱈅	zsnb
𰾱	zsoa
摠	zsqa
𡕰	zsua
緫	zsva
𰬥	zsvb
𰬰	zsvc
蒩	zuta
靻	zutb
𦑋	zuya
𧇈	zuyd
𧇿	zuyg
𪙳	zuyh
𩼦	zzna
