-- 纠错码表
-- 格式： 占位#占位#占位#占位    正确编码
污水管道工程	污水管网工程
连#_#连#_	边$1边$2
连#__#连#__	边$1边$2
月#_#月#_	越$1越$2
很熟付	很舒服
德阳子	的样子
啥事后	啥时候
有事后	有时候
一步分	一部分
卧室是	我试试
逆势是	你试试
大叔句	大数据
及时本	记事本
杂烩是	咋回事？
不惜关	不习惯
大步分	大部分
比较元	比较远
有点元	有点远
太远市	太原市
一倍子	一辈子
小时后	小时候
补正长	不正常
霸王茶几	霸王茶姬
坐下叫	左下角
游侠叫	右下角
五标题	无标题